Rrc, Gs^Fp, Gs^Fp, Gs^Fp, Gs^Fp, Gs^Fp, Gs^Fp, Gs^Fp, Mm^Xm, Mm^Xm, Mm^Xm, Mm^Xm, Mm^Xm, Mm^Xm, Mm^Xm, Mm^Xm, Mm^Xm, Mm^Xm, Mm^Xm, Mm^Xm, Mm^Xm, Gg, Mm^Xm, Mm^Xm, Mm^Xm, Mm^Xm, Mm^Xm, Mm^Xm, Mm^Xm, Mm^Xm, Mm^Xm, Mm^Xm, Mm^Xm, Mm^Xm, Mm^Xm, Mm^Xm, Mm^Xm, Mm^Xm, Mm^Xm, Mm^Xm, Mm^Xm, Hh, Mm^Xm, Hh, Mm^Xm, Mm^Xm, Mm^Xm, Mm^Xm, Mm^Xm, Ql, Ql, Ql, Re^Qhh, Ql, Ql, Mm^Xm, Mm^Xm, Mm^Xm, Mm^Xm, Mm^Xm, Mm^Xm, Mm^Xm
Rrc, Rrc, Rrc, Gs^Fp, Gs^Fp, Gs^Fp, Gs^Fp, Gs^Fp, Gg, Mm^Xm, Mm^Xm, Mm^Xm, Mm, Mm^Xm, Mm, Mm^Xm, Mm^Xm, Mm^Xm, Mm^Xm, Mm^Xm, Mm^Xm, Mm^Xm, Gs^Fp, Mm^Xm, Gs^Fp, Mm^Xm, Gg, Mm^Xm, Gg, Gg, Gs^Fp, Gs^Fp, Gs^Fp, Gs^Fp, Gg, Mm^Xm, Hh, Mm^Xm, Hh, Mm^Xm, Mm^Xm, Mm^Xm, Mm^Xm, Mm^Xm, Mm^Xm, Mm^Xm, Hh, Mm^Xm, Gg, Ql, Rd, Ql^Bs/, Ql, Ql^Bs\, Rd^Qhh, Ql^Bs/, Re, Gs^Fp, Gs^Fp, Mm^Xm, Mm^Xm, Mm^Xm
Rrc, Rrc, Rrc, Rrc, 1 Rrc, Gs^Fp, Gs^Fp, Gs^Fp, Mm^Xm, Mm^Xm, Mm^Xm, Mm, Mm, Mm, Rrc, Ch, Ch, Mm^Xm, Mm^Xm, Mm^Xm, Gs^Fp, Gg^Fet, Gs^Fp, Gs^Fp, Gs^Fp, Gs^Fp, Gg^Fet, Gg, Gg^Fmw, Gg, Gs^Fp, Gs^Fp, Gg^Ve, Gs^Fp, Gg, Hh, Hh, Hh, Hh^Fms, Hh, Hh, Hh^Vhh, Hh, Mm, Hh, Hh^Fmf, Rd, Gg, Ql, Rd, Ql^Bs\, Ql, Ql^Bs/, Rd^Qhh, Ql^Bs\, Ql, Ql, Gs^Fp, Chr, Chr, Aa^Fpa, Mm^Xm
Gs^Fp, Rrc, 2 Rrc, Rrc, Rrc, Rrc, Rrc, Gg, Mm^Xm, Mm^Xm, Rrc, Mm, Rrc, Rrc, Rrc, Rrc, Rrc, Ch, Gg, Gs^Fp, Rd, Gs^Fp, Rd, Gs^Fp, Rd, Rd, Rd, Gg, Gs^Fds, Gs^Fms, Gg, Gs^Fp, Gs^Fp, Gs^Fp, Gg, Gg, Gg, Hh, Hh, Hh, Hh, Hh, Rd, Hh, Rd, Rd, Gg, Rd, Rd, Ql, Ql^Bs/, Rb^Qhh, Ql^Bs\, Ql, Ql, Rd, Rd, Chr, 8 Khr, Chr, Aa^Fpa, Mm^Xm
Gs^Fp, Gs^Fp, Gs^Fp, Rrc, Rrc, Rrc, Rrc, Rrc, Rrc, Rrc, Rrc, Rrc, Cer, Cer, Cer, Rrc, Rrc, Ch, Rd, Rd, Gs^Fp, Rd, Gs^Fp, Rd, Gs^Fp, Gs^Fp, Gs^Fp, Rd, Rd, Gg^Fet, Gg, Gs^Fp, Rd, Gg, Rd, Gg, Rd, Hh, Rd, Rd, Rd, Rd, Gg, Rd, Mm^Xm, Gg, Mm, Gg^Efm, Ql, Rd, Ql^Bs\, Ql, Ql^Bs/, Rd, Rd, Rd, Rb, Chr, Chr, Chr, Aa^Fpa, Mm^Xm
Gg, Gs^Fp, Mm^Xm, Gg, Gg, Rrc, Rrc, Rrc, Rrc, Rrc, Rrc, Rrc, Cer, Ker, Cer, Rrc, Rrc, Ch, Gg, Gs^Fp, Gs^Fms, Gs^Fp, Gs^Fp, Gs^Fp, Gg^Fet, Gs^Fms, Gs^Fp, Gs^Fp, Gg, Rd, Rd, Rd, Rd, Rd, Gs^Fp, Rd, Gs^Fp, Rd, Gs^Fp, Rd, Gs^Fp, Gg, Gg^Efm, Rd, Gg, Mm^Xm, Mm^Xm, Hh, Mm, Ql, Ql, Rb^Qhh, Ql^Bs\, Ql, Rd, Gs^Fp, Gs^Fp, Chr, Chr, Aa^Fpa, Aa^Fpa, Mm^Xm
Mm^Xm, Mm^Xm, Mm^Xm, Mm, Mm^Xm, Mm^Xm, Rrc, Rrc, Rrc, Rrc, Rrc, Rrc, Rrc, Cer, Rrc, Rrc, Rrc, Ch, Gg, Gs^Fp, Gs^Fms, Gs^Fp, Gs^Fp, Gs^Fp, Gs^Fp, Gs^Fp, Gs^Fp, Gs^Fp, Gg, Gg, Gg^Fet, Gg, Gs^Fp, Rd, Rd, Gs^Fp, Gs^Fp, Gs^Fp, Gg^Fet, Gs^Fp, Gs^Fp, Gg, Gg, Rd, Gg^Efm, Gg, Mm^Xm, Mm^Xm, Hh, Ql, Ql, Ql, Ql, Rd, Gs^Fp, Gs^Fetd, Aa^Fpa, Aa^Fpa, Aa^Fpa, Aa^Fpa, Gs^Fp, Gs^Fp
Mm^Xm, Mm^Xm, Mm^Xm, Mm^Xm, Mm^Xm, Rrc, Rrc, Rrc, Cer, Rrc, Rrc, Rrc, Rrc, Rrc, Rrc, Rrc, Cha, Ch, Aa, Gg, Gg, Gs^Fp, Gs^Fp, Gg^Ve, Gs^Fp, Gs^Fp, Gg, Gg^Fet, Gg, Gg, Gg, Gg, Gs^Fms, Gs^Fp, Gs^Fp, Rd, Rd, Gs^Fp, Gs^Fp, Gs^Fp, Gg, Gg^Efm, Gg, Rd, Gg, Gs^Fp, Mm, Mm^Xm, Ql, Ql^Bs\, Mm, Ql, Rd, Rd, Gs^Fp, Aa^Vha, Aa^Fpa, Aa^Fpa, Aa^Fpa, Aa^Fpa, Mm^Xm, Mm^Xm
Mm^Xm, Mm^Xm, Mm, Mm, Rrc, Rrc, Rrc, Cer, Ker, Cer, Rrc, Rrc, Rrc, Rrc, Rrc, Rra, Rra, Qxu^Xo, Qxu^Xo, Gg, Gg, Gs^Fp, Gs^Fp, Gs^Fp, Gs^Fp, Gg, Gg, Gg, Gg, Gg, Gg, Gs^Fp, Gs^Fp, Gs^Fms, Gs^Fp, Gs^Fp, Gs^Fp, Rd, Rd, Gg, Gg^Efm, Gg, Rd, Rd, Gs^Fp, Gs^Fp, Gs^Fp, Mm^Xm, Mm^Xm, Ql, Mm^Xm, Ha, Rd, Gs^Fms, Aa, Aa^Fpa, Aa, Aa^Fma, Aa, Aa^Fpa, Mm^Xm, Mm^Xm
Mm, Mm, Mm, Mm, Rrc, Rrc, Rrc, Cer, Cer, Cer, Rrc, Rrc, Rrc, Rrc, Rra, Rra, Rra, Rra^Ecf, Rra, Qxu^Xo, Qxu^Xo, Gg, Gg, Gs^Fp, Gg, Gg, Gg, Gs^Fms, Gs^Fms, Chr, Chr, Gs^Fp, Gs^Fms, Gs^Fp, Gs^Fp, Gs^Fp, Gg, Gg, Gg, Rd, Rd, Gg^Efm, Rd, Gs^Fp, Gs^Fp, Gg^Vh, Gs^Fp, Mm^Xm, Mm^Xm, Mm^Xm, Mm^Xm, Ha, Aa, Rd, Rd, Aa^Fpa, Aa, Aa, Aa, Aa, Aa, Mm^Xm
Mm, Mm^Xm, Mm^Xm, Ch, Ch, Rrc, Rrc, Rrc, Rrc, Rrc, Ch, Rrc, Ch, Cha, Qxu^Xo, Rra^Ecf, Rra, Rra, Rra, Rra^Ecf, Rra, Qxu^Xo, Qxu^Xo, Gg, Gg, Gs^Fms, Gg, Gg, Gs^Fms, Gs^Fms, Gg^Fet, Gs^Fp, Gs^Fp, Gg^Ve, Gs^Fp, Gs^Fp, Gs^Fp, Gg, Gg, Gg, Gg, Rd, Rb, Gs^Fp, Gs^Fp, Gs^Fp, Mm^Xm, Mm, Mm^Xm, Mm^Xm, Mm^Xm, Mm^Xm, Aa, Aa, Aa, Rd, Aa, Aa, Aa^Fpa, Aa^Fpa, Aa^Fpa, Mm^Xm
Mm^Xm, Mm^Xm, Mm^Xm, Qxe, Gg, Ch, Ch, Ch, Ch, Ch, Mm^Xm, Ch, Gg, Gg^Efm, Gg, Qxu^Xo, Qxu^Xo, Rra^Ecf, Rra, Rra, Rra, Rra^Ecf, Rra, Qxu^Xo, Qxu^Xo, Gg, Gg, Gg, Gg, Chr, Gg, Chr, Gg, Gs^Fp, Gg^Fet, Gs^Fp, Gs^Fp, Gg, Gg, Gg^Vh, Co, Rd, Rd, Gs^Fp, Gs^Fp, Gs^Fp, Mm^Xm, Mm^Xm, Mm^Xm, Mm^Xm, Mm^Xm, Mm, Aa^Fpa, Aa, Aa, Rd, Aa, Aa^Fma, Aa^Fpa, Aa^Fpa, Hh^Fp, Mm^Xm
Mm^Xm, Mm^Xm, Mm^Xm, Mm^Xm, Gg, Gg, Gs, Rd, Gg, Gg, Gg, Gg, Gg, Gg, Gg, Gg, Gg, Qxu^Xo, Qxu^Xo, Rra^Ecf, Rra, Rra, Rra, Rra^Ecf, Rra, Qxu^Xo, Qxu^Xo, Gg^Qhu, Gg^Qhu, Gs^Fms, Gg, Gg, Gs^Fp, Gs^Fp, Gs^Fp, Gs^Fp, Gs^Fp, Gg, Co, Gg, Co, Co, Rd, Gs^Fp, Gs^Fp, Gs^Fp, Mm^Xm, Mm^Xm, Mm^Xm, Mm^Xm, Aa^Fpa, Aa^Fpa, Aa^Fpa, Aa^Fpa, Aa, Rd, Aa, Aa^Fpa, Aa^Fpa, Aa^Vea, Mm^Xm, Mm^Xm
Mm^Xm, Mm^Xm, Gg^Efm, Gg^Efm, Gs, Gs, Gs, Rd, Gg^Fet, Gg, Gg, Hh, Hh, Hh, Hh^Fp, Gg^Fet, Gg, Gg, Mm^Xm, Qxu^Xo, Qxu^Xo, Rra^Ecf, Rra, Rra, Rra, Rra^Ecf, Rra, Qxu^Xo, Qxu^Xo, Gg^Qhu, Gg^Qhu, Gs^Qhuf, Gs^Fp, Gs^Fp, Gs^Fp, Gs^Fp, Gg, Gg, Hh, Co, 3 Ko, Co, Co, Co, Gs^Fp, Mm, Mm^Xm, Mm^Xm, Mm, Aa^Fpa, Aa^Fpa, Aa^Feta, Aa^Fpa, Aa^Fpa, Aa, Rd, Rd, Aa, Aa^Fpa, Aa^Fpa, Mm^Xm, Mm^Xm
Mm^Xm, Mm^Xm, Gg, Gg, Gg, Gs, Rd, Rd, Gg, Gg^Fet, Hh, Hh^Vhh, Hh, Hh, Hh, Gg, Mm^Xm, Mm^Xm, Mm, Mm^Xm, Mm^Xm, Qxu^Xo, Qxu^Xo, Rra^Ecf, Rra, Rra, Rra, Rra^Ecf, Rra, Qxu^Xo, Qxu^Xo, Gs^Qhuf, Gs^Qhuf, Gs^Fp, Gs^Qhuf, Gg^Qhu, Qxu^Xo, Qxu^Xo, Qxu^Xo, Hh, Rb, Rd, Co, Co, Mm^Xm, Mm^Xm, Mm^Xm, Mm^Xm, Rb, Aa^Fpa, Aa^Fpa, Aa^Fpa, Aa^Fpa, Aa^Fpa, Aa, Aa, Rd, Aa^Fpa, Aa^Fpa, Aa^Fpa, Mm^Xm, Mm^Xm
Mm^Xm, Mm, Gg, Gg, Gg^Fet, Gs, Rd, Hh^Fds, Gs, Gg^Efm, Gg, Hh, Hh, Hh, Mm^Xm, Mm^Xm, Mm^Xm, Mm, Mm, Mm^Vhh, Mm, Mm, Mm, Qxu^Xo, Qxu^Xo, Rra^Ecf, Rra, Rra, Rra, Rra^Ecf, Rra, Qxu^Xo, Qxu^Xo, Gs^Qhuf, Qxu^Xo, Qxu^Xo, Rra, Rra^Ecf, Rra, Qxu^Bh/, Qxu^Xo, Gs^Fp, Mm^Xm, Mm^Xm, Mm^Xm, Mm^Xm, Mm^Xm, Mm^Xm, Ai, Rd, Rd, Aa^Fma, Rd, Aa^Fpa, Rd, Rd, Rd, Aa^Fpa, Aa^Fpa, Aa^Fpa, Mm^Xm, Mm^Xm
Mm^Xm, Gg, Gg, Gg^Efm, Gg, Gg^Efm, Rd, Gg, Gs, Gs, Gg^Fet, Gg, Mm^Xm, Mm^Xm, Mm^Xm, Mm^Xm, Wwr, Mm, Mm, Mm, Mm, Mm, Mm, Mm, Gg, Qxu^Xo, Qxu^Xo, Rra^Ecf, Rra, Rra, Rra, Rra^Ecf, Rra, Qxu^Xo, Rra, Rra^Ecf, Rra, Rra, Rra, Rra^Ecf, Qxu^Xo, Qxu^Xo, Aa^Fpa, Mm^Xm, Mm, Mm^Xm, Ai, Ai, Ai, Ai, Aa^Fpa, Rd, Aa^Fpa, Rd, Aa^Fpa, Aa^Fma, Aa, Rd, Ha, Ha, Mm^Xm, Mm^Xm
Mm^Xm, Gg, Gg, Gg, Gg, Rd, Gg, Gg, Gg^Efm, Gs, Gg, Mm, Mm^Xm, Mm^Xm, Mm^Xm, Mm^Xm, Ww, Ww, Chw, Chr, Chr, Mm, Gg, Mm, Gs^Fms, Gs^Qhuf, Gs^Qhuf, Qxu^Xo, Qxu^Xo, Rra^Ecf, Rra, Rra, Tf, Rra^Ecf, Tf, Rra, Rra, Rra^Ecf, Qxu^Xo, Qxu^Xo, Aa^Fpa, Aa^Fpa, Aa^Fpa, Aa^Fpa, Aa^Fpa, Aa^Fpa, Aa^Fpa, Aa^Fpa, Rd, Rb, Aa^Fpa, Aa^Fpa, Aa^Fpa, Aa^Fpa, Aa^Fpa, Aa^Fpa, Aa, Rd, Ha^Fpa, Ha, Mm^Xm, Mm^Xm
Mm^Xm, Mm^Xm, Gg, Gg^Fet, Rd, Rd, Gg, Gg^Efm, Gg, Gg, Gg, Mm^Xm, Mm^Xm, Mm^Xm, Wwr, Ww, Ww, Ww, Chw, Chr, Chr, Gg, Gg^Efm, Gg, Gg, Gs^Fms, Gs^Qhuf, Gs^Qhuf, Qxu^Xo, Qxu^Xo, Rra, Rra^Ecf, Tf, Tf, Tf, Rra^Ecf, Rra, Qxu^Xo, Qxu^Xo, Aa^Fpa, Aa^Fpa, Aa^Fpa, Aa^Fpa, Aa^Vea, Aa^Fpa, Aa^Fpa, Aa^Fpa, Aa^Fpa, Rd, Aa^Fpa, Aa^Feta, Aa^Fpa, Aa^Vea, Aa^Fpa, Aa^Fpa, Aa, Aa, Rd, Ha, Aa^Fpa, Mm^Xm, Mm^Xm
Mm^Xm, Gg, Gg, Rd, Rd, Rd, Gg, Gs^Fp, Gs^Fp, Sm, Mm, Mm^Xm, Mm^Xm, Mm^Xm, Wo, Wo, Ww, Chw, Chw, 7 Khr, Rp, Rp, Gg, Gg, Gs^Qhuf, Gs^Qhuf, Qxu^Xo, Qxu^Xo, Rra, Rra^Ecf, Rra, Rra, Rra, Rra^Ecf, Rra, Rra, Rra, Rra^Ecf, Rra, Qxu^Xo, Qxu^Xo, Aa^Fpa, Aa^Qhuf, Aa^Fpa, Aa^Fma, Aa^Fpa, Aa^Fpa, Aa^Fpa, Rd, Aa^Fpa, Aa^Fpa, Aa^Fpa, Aa, Aa^Fpa, Aa, Coa, Rd, Rd, Ha^Fma, Aa^Fpa, Mm^Xm, Mm^Xm
Mm^Xm, Mm, Gg, Rd, Hh^Fp, Gs^Fp, Gs^Fp, Hh^Fp, Aa^Fpa, Gs^Fp, Mm^Xm, Mm^Xm, Wo, Wo, Wo, Ww, Ww, Chw, Wwr, Rp, Rp, Gg, Gg^Efm, Gg, Gg^Vh, Qxu^Xo, Qxu^Xo, Rra^Ecf, Rra, Rra, Rra, Rra^Ecf, Qxu^Xo, Qxu^Xo, Qxu^Xo, Rra^Ecf, Rra, Rra, Rra, Rra^Ecf, Rra, Qxu^Xo, Qxu^Xo, Aa^Fpa, Aa^Qhuf, Aa^Fpa, Aa, Aa^Fpa, Rd, Aa^Fpa, Aa^Fpa, Aa^Fpa, Aa, Aa, Chr, Chr, Chr, Cea, Ha, Aa^Fpa, Mm^Xm, Mm^Xm
Mm^Xm, Mm^Xm, Gg^Efm, Rd, Gg, Gs^Fp, Ha^Fpa, Aa^Fpa, Aa^Fpa, Mm^Xm, Mm^Xm, Mm^Xm, Wo, Wo, Wo, Ww, Ww, Ww, Gg^Efm, Gg, Rp, Gs, Gs, Gg, Gg^Efm, Gg, Rp, Qxu^Bh/, Qxu^Xo, Rra^Ecf, Qxu^Xo, Qxu^Xo, Gs^Fp, Hh^Fp, Gs^Fp, Qxu^Xo, Qxu^Xo, Rra^Ecf, Rra, Rra, Rra, Rra^Ecf, Rra, Qxu^Xo, Qxu^Xo, Aa^Qhu, Rd, Rd, Aa^Fpa, Rd, Rd, Aa^Fpa, Aa, Coa, Chr, 6 Kea, Ce, Rd, Ha, Aa^Fpa, Mm^Xm, Xuc
Mm^Xm, Mm^Xm, Gg, Rd, Gg, Gs^Fp, Aa^Fpa, Aa^Fpa, Mm, Mm^Xm, Mm^Xm, Wo, Wo, Wo, Wo, Ww, Gg^Fet, Gg, Gs, Gg, Rp, Gs, Gg, Gg, Rp, Rp, Gs^Fp, Gs^Fp, Gs^Fp, Qxu^Xo, Gs^Fp, Gs^Fp, Gs^Fp, Gs^Fms, Gs^Fp, Gs^Fp, Gs^Fp, Qxu^Xo, Qxu^Xo, Rra^Ecf, Rra, Rra, Rra, Rra^Ecf, Rra, Qxu^Xo, Qxu^Xo, Aa^Qhu, Aa^Qhu, Aa^Qhuf, Aa^Fpa, Rd, Rd, Aa, Ce, Ai, Xuc, Rd, Xuc, Xuc, Xuc, Xuc
Mm^Xm, Mm, Ha, Rd, Rd, Gs^Fp, Ha, Aa^Fpa, Mm^Xm, Mm^Xm, Mm^Xm, Wo, Wo, Wo, Ww, Ww, Gg^Vh, Gs, Gg^Efm, Gg, Rp, Gs, Rp, Rp, Hh, Rd, Rd, Gs^Fp, Gs^Fp, Gs^Fp, Gs^Fp, Gs^Fp, Gd^Fetd, Gs^Fms, Gs^Fp, Gs^Fms, Gs^Fp, Mm, Mm, Qxu^Xo, Qxu^Xo, Rra^Ecf, Rra, Rra, Rra, Rra^Ecf, Rra, Qxu^Xo, Qxu^Xo, Aa^Qhu, Aa, Aa^Fpa, Aa, Rd, Xuc, Xuc, Ha, Xuc, Ha, Ha, Gg^Efm, Mm^Xm
Mm^Xm, Ha, Ha^Fpa, Gg, Rd, Gg, Ha, Ha^Vhha, Mm, Mm^Xm, Mm^Xm, Wo, Wo, Wo, Ww, Ww, Gg^Efm, Gg, Gg, Gg^Fet, Rp, Rp, Hh, Hh, Hh, Rd, Rd, Gs^Fp, Gs^Fp, Gs^Fms, Gs^Fp, Gs^Fp, Gs^Fp, Gs^Fp, Gs^Fp, Gs^Fp, Gs^Fp, Mm, Mm, Mm, Mm, Qxu^Xo, Qxu^Xo, Rra^Ecf, Rra, Rra, Rra, Rra^Ecf, Rra, Qxu^Xo, Qxu^Xo, Aa, Xuc, Xuc, Ha, Ha, Ha, Rd, Aa^Fpa, Aa^Fpa, Mm, Mm^Xm
Mm^Xm, Ha, Ha, Ha, Rb, Rd, Ha, Ha, Gg, Mm^Xm, Mm^Xm, Wo, Wo, Wo, Ww, Ww, Gg, Gg^Fet, Rp, Rp, Hh, Hh, Hh, Hh^Fms, Hh, Hh, Hh, Rd, Rd, Gs^Fp, Rd, Gs^Fp, Gs^Fms, Gs^Fp, Gs^Fms, Gs^Fp, Gs^Fp, Gs^Fp, Mm, Mm, Mm, Mm, Mm, Qxu^Xo, Qxu^Xo, Rra^Ecf, Rra, Rra, Rra, Rra^Ecf, Rra, Qxu^Xo, Qxu^Xo, Xuc, Ha, Ha, Cha, Rd, Gs^Fp, Mm, Mm^Xm, Mm
Mm^Xm, Aa^Vea, Gg, Sm, Rd, Rd, Ha, Ha, Mm^Xm, Mm^Xm, Mm^Xm, Wo, Wo, Wo, Ww, Ww, Gg, Rp, Hh, Hh, Mm, Mm, Mm, Hh, Hh, Hh, Hh, Hh, Hh, Rd, Rd, Rd, Rd, Gs^Fp, Gs^Fp, Gs^Fp, Mm, Mm, Mm, Mm, Mm, Mm, Mm, Mm^Vhh, Mm, Qxu^Xo, Qxu^Xo, Rra^Ecf, Rra, Rra, Rra, Rra^Ecf, Rra, Qxu^Xo, Cha, Cha, Rrc, Cha, Mm^Xm, Mm^Xm, Mm, Mm^Xm
Mm^Xm, Mm^Xm, Mm, Rd, Ha, Ha^Fms, Ai, Mm, Ai, Mm^Xm, Mm^Xm, Mm^Xm, Wo, Wwr, Wwf, Gg, Rp, Rp, Hh, Hh, Mm, Mm, Mm, Mm, Mm, Mm, Hh, Hh^Vhh, Hh, Hh, Hh, Hh, Hh, Rd, Gg, Gg^Efm, Gg, Mm, Mm, Mm, Mm, Mm, Hh, Chr, Hh, Mm, Ce, Qxu^Xo, Qxu^Xo, Rra^Ecf, Rra, Rra, Rra, Rra, Rrc, Rrc, Mm^Xm, Mm^Xm, Mm^Xm, Mm^Xm, Gg, Mm
Mm^Xm, Mm, Mm, Mm, Mm, Ha, Wo, Ai, Wwr, Wo, Mm^Xm, Mm^Xm, Wwf, Wwf, Wwf, Rp, Hh, Hh, Hh, Hh, Mm, Mm, Mm, Mm, Mm, Hh, Mm, Hh, Hh, Hh, Hh^Fms, Hh, Hh, Rd, Rd, Gg^Efm, Gg^Fet, Mm, Mm, Mm, Mm, Mm, Chr, Ce, 5 Ke, Ce, Xuc, Xuc, Xuc, Qxu^Xo, Cha, Rra, Rra, Rrc, Rrc, Rrc, Rrc, Gg, Gg, Gg, Gs^Fp, Gg
Mm, Mm, Chr, Mm, Ds, Wo, Wo, Wo, Wwf, Wwf, Wwf, Wwf, Wwf, Wwf, Wwf, Hh, Hh, Hh, Hh, Mm, Mm, Mm, Mm, Mm, Mm, Mm, Mm, Mm, Mm, Hh, Hh, Hh, Hh, Gg, Gg, Rd, Rd, Rd, Rd, Mm, Mm, Mm, Mm, Chr, Ce, Xuc, Ha, Ha, Ch, Ch, Rra, Rra, Mm^Xm, Rrc, Rrc, Rrc, Rrc, Rrc, Rrc, Gg^Efm, Gg^Fet, Gg
Mm, Mm, Hh, Hh, Chr, Chs, Chr, Ww^Bw/, Wwf^Bw\, Wwf, Ww, Wwf, Ww, Wwf, Wwf, Hh, Mm^Xm, Hh, Mm, Mm, Mm, Mm, Mm, Mm, Mm^Vhh, Mm, Mm, Mm, Mm, Mm, Hh, Hh, Mm, Gg^Efm, Gg^Efm, Gg, Mm, Rd, Rd, Rd, Rd, Mm, Rd, Ce, Hh, Xuc, Ha, Ha, Rb, Ch, Mm^Xm, Mm^Xm, Mm^Xm, Gg, Gs^Fp, Rrc, Rrc, Rrc, Rrc, Rrc, Rrc, Gg
Mm, Chr, Chr, Chr, Chr, Mm, Mm, Mm, Mm, Ww^Bw\, Ww, Ww, Wo, Ww, Ww, Mm^Xm, Mm^Xm, Mm^Xm, Mm^Xm, Wwr, Mm, Mm, Mm, Mm, Mm, Mm, Mm, Mm, Mm, Mm, Mm, Mm, Mm, Gg^Efm, Gg, Gg^Fet, Mm, Mm, Mm, Mm, Mm, Rd, Mm, Chr, Rd, Xuc, Rd, Rd, Ha, Aa^Fpa, Mm, Mm^Xm, Mm^Xm, Gs^Fp, Gs^Fp, Gg^Efm, Gg^Efm, Rrc, Rrc, Rrc, Rrc, Rrc
Mm, Mm, Chr, 4 Khr, Chr, Chr, Mm, Mm^Vhh, Mm^Xm, Mm^Xm, Mm^Xm, Mm^Xm, Wo, Ww, Ww, Ww, Ww, Ww, Ww, Ww, Mm, Mm, Mm, Mm^Xm, Mm^Xm, Mm, Mm^Xm, Mm, Mm^Xm, Mm, Mm^Xm, Mm, Mm^Xm, Mm, Mm^Xm, Mm, Mm, Mm, Mm, Mm, Mm^Xm, Mm, Mm, Mm, Xuc, Xuc, Ha, Ha, Aa^Fpa, Aa^Fpa, Mm^Xm, Mm^Xm, Mm, Gs^Fp, Gg^Efm, Gg^Efm, Gg, Gg, Gg, Rrc, Rrc, Rrc
Mm, Mm, Mm, Mm, Mm, Mm, Mm, Mm, Mm^Xm, Mm^Xm, Mm^Xm, Wo, Wo, Wo, Ww, Wo, Wo, Mm^Xm, Mm^Xm, Mm^Xm, Mm^Xm, Mm^Xm, Mm^Xm, Mm^Xm, Mm^Xm, Mm^Xm, Mm^Xm, Mm^Xm, Mm^Xm, Mm^Xm, Mm^Xm, Mm^Xm, Mm^Xm, Mm^Xm, Mm, Mm^Xm, Mm^Xm, Mm^Xm, Mm^Xm, Mm^Xm, Mm^Xm, Mm^Xm, Mm^Xm, Mm^Xm, Mm^Xm, Mm^Xm, Mm^Xm, Mm^Xm, Mm^Xm, Mm^Xm, Mm^Xm, Mm^Xm, Mm^Xm, Gg, Gg, Gg^Fet, Gg, Hh, Gg, Gs^Fp, Gg, Rrc
