border_size=1
usage=map

Rr          , Gs^Fp       , Gs^Fp       , Gs^Fp       , Gs^Fp       , Gs^Fp       , Gs^Fp       , Gs^Fp       , Mm^Xm       , Mm^Xm       , Mm^Xm       , Mm^Xm       , Mm^Xm       , Mm^Xm       , Mm^Xm       , Mm^Xm       , Mm^Xm       , Mm^Xm       , Mm^Xm       , Mm^Xm       , Mm^Xm       , Gg          , Mm^Xm       , Mm^Xm       , Mm^Xm       , Mm^Xm       , Mm^Xm       , Mm^Xm       , Mm^Xm       , Mm^Xm       , Mm^Xm       , Mm^Xm       , Mm^Xm       , Mm^Xm       , Mm^Xm       , Mm^Xm       , Mm^Xm       , Mm^Xm       , Mm^Xm       , Mm^Xm       , Mm^Xm       , Hh          , Mm^Xm       , Hh          , Mm^Xm       , Mm^Xm       , Mm^Xm       , Mm^Xm       , Mm^Xm       , Ql          , Ql          , Ql          , Re          , Ql          , Ql          , Mm^Xm       , Mm^Xm       , Mm^Xm       , Mm^Xm       , Mm^Xm       , Mm^Xm       , Mm^Xm       
Rr          , Rr          , Rr          , Gs^Fp       , Gs^Fp       , Gs^Fp       , Gs^Fp       , Gs^Fp       , Gg          , Mm^Xm       , Mm^Xm       , Mm^Xm       , Mm          , Mm^Xm       , Mm          , Mm^Xm       , Mm^Xm       , Mm^Xm       , Mm^Xm       , Mm^Xm       , Mm^Xm       , Mm^Xm       , Gs^Fp       , Mm^Xm       , Gs^Fp       , Mm^Xm       , Gg          , Mm^Xm       , Gg          , Gg          , Gs^Fp       , Gs^Fp       , Gs^Fp       , Gs^Fp       , Gg          , Mm^Xm       , Hh          , Mm^Xm       , Hh          , Mm^Xm       , Mm^Xm       , Mm^Xm       , Mm^Xm       , Mm^Xm       , Mm^Xm       , Mm^Xm       , Hh          , Mm^Xm       , Gg          , Ql          , Rd          , Ql^Bs/      , Ql          , Ql^Bs\      , Rd          , Ql^Bs/      , Re          , Gs^Fp       , Gs^Fp       , Mm^Xm       , Mm^Xm       , Mm^Xm       
Rr          , Rr          , Rr          , Rr          , 1 Rr        , Gs^Fp       , Gs^Fp       , Gs^Fp       , Mm^Xm       , Mm^Xm       , Mm^Xm       , Mm          , Mm          , Mm          , Rr          , Ch          , Ch          , Mm^Xm       , Mm^Xm       , Mm^Xm       , Gs^Fp       , Gs^Fp       , Gs^Fp       , Gs^Fp       , Gs^Fp       , Gs^Fp       , Gg^Fet      , Gg          , Gg          , Gg          , Gs^Fp       , Gs^Fp       , Gg^Ve       , Gs^Fp       , Gg          , Hh          , Hh          , Hh          , Hh          , Hh          , Hh          , Hh^Vhh      , Hh          , Mm^Xm       , Hh          , Hh          , Rd          , Gg          , Ql          , Rd          , Ql^Bs\      , Ql          , Ql^Bs/      , Rd          , Ql^Bs\      , Ql          , Ql          , Gs^Fp       , Chr         , Chr         , Aa^Fpa      , Mm^Xm       
Gs^Fp       , Rr          , 2 Rr        , Rr          , Rr          , Rr          , Rr          , Rr          , Mm^Xm       , Mm^Xm       , Rr          , Mm          , Rr          , Rr          , Rr          , Rr          , Rr          , Ch          , Gg          , Gs^Fp       , Rd          , Gs^Fp       , Rd          , Gs^Fp       , Rd          , Rd          , Rd          , Gg          , Gg^Fet      , Gg^Fet      , Gg          , Gs^Fp       , Gs^Fp       , Gs^Fp       , Gg          , Gg          , Gg          , Hh          , Hh          , Hh          , Hh          , Hh          , Rd          , Hh          , Rd          , Rd          , Gg          , Rd          , Rd          , Ql          , Ql^Bs/      , Rb          , Ql^Bs\      , Ql          , Ql          , Rd          , Rd          , Chr         , 8 Khr       , Chr         , Aa^Fpa      , Mm^Xm       
Gs^Fp       , Gs^Fp       , Gs^Fp       , Rr          , Rr          , Rr          , Rr          , Rr          , Rr          , Rr          , Rr          , Rr          , Ch          , Ch          , Ch          , Rr          , Rr          , Ch          , Rd          , Rd          , Gs^Fp       , Rd          , Gs^Fp       , Rd          , Gs^Fp       , Gs^Fp       , Gs^Fp       , Rd          , Rd          , Gg^Fet      , Gg          , Gs^Fp       , Rd          , Gg          , Rd          , Gg          , Rd          , Hh          , Rd          , Rd          , Rd          , Rd          , Gg          , Rd          , Mm^Xm       , Gg          , Mm^Xm       , Gg^Efm      , Ql          , Rd          , Ql^Bs\      , Ql          , Ql^Bs/      , Rd          , Rd          , Rd          , Rb          , Chr         , Chr         , Chr         , Aa^Fpa      , Mm^Xm       
Gg          , Gs^Fp       , Mm^Xm       , Gg          , Rr          , Rr          , Rr          , Rr          , Rr          , Rr          , Rr          , Rr          , Ch          , Kh          , Ch          , Rr          , Rr          , Ch          , Gg          , Gs^Fp       , Gs^Fp       , Gs^Fp       , Gs^Fp       , Gs^Fp       , Gs^Fp       , Gs^Fp       , Gs^Fp       , Gs^Fp       , Gg          , Rd          , Rd          , Rd          , Rd          , Rd          , Gs^Fp       , Rd          , Gs^Fp       , Rd          , Gs^Fp       , Rd          , Gs^Fp       , Gg          , Gg^Efm      , Rd          , Gg          , Mm^Xm       , Mm^Xm       , Mm^Xm       , Mm^Xm       , Ql          , Ql          , Rb          , Ql^Bs\      , Ql          , Rd          , Gs^Fp       , Gs^Fp       , Chr         , Chr         , Aa^Fpa      , Aa^Fpa      , Mm^Xm       
Mm^Xm       , Mm^Xm       , Mm^Xm       , Mm          , Mm^Xm       , Mm^Xm       , Rr          , Rr          , Rr          , Rr          , Rr          , Rr          , Rr          , Ch          , Rr          , Rr          , Rr          , Ch          , Gg          , Gs^Fp       , Gs^Fp       , Gs^Fp       , Gs^Fp       , Gs^Fp       , Gs^Fp       , Gs^Fp       , Gs^Fp       , Gs^Fp       , Gg          , Gg          , Gg^Fet      , Gg          , Gs^Fp       , Rd          , Rd          , Gs^Fp       , Gs^Fp       , Gs^Fp       , Gs^Fp       , Gs^Fp       , Gs^Fp       , Gg          , Gg          , Rd          , Gg^Efm      , Gg          , Mm^Xm       , Mm^Xm       , Mm^Xm       , Ql          , Ql          , Ql          , Ql          , Rd          , Gs^Fp       , Gs^Fp       , Aa^Fpa      , Aa^Fpa      , Aa^Fpa      , Aa^Fpa      , Gs^Fp       , Gs^Fp       
Mm^Xm       , Mm^Xm       , Mm^Xm       , Mm^Xm       , Mm^Xm       , Rr          , Rr          , Rr          , Ch          , Rr          , Rr          , Rr          , Rr          , Rr          , Rr          , Rr          , Ch          , Ch          , Aa          , Gg          , Gg          , Gs^Fp       , Gs^Fp       , Gg^Ve       , Gs^Fp       , Gs^Fp       , Gg          , Gg^Fet      , Gg          , Gg          , Gg          , Gg          , Gs^Fp       , Gs^Fp       , Gs^Fp       , Rd          , Rd          , Gs^Fp       , Gs^Fp       , Gs^Fp       , Gg          , Gg^Efm      , Gg          , Rd          , Gg          , Gs^Fp       , Mm^Xm       , Mm^Xm       , Ql          , Ql          , Mm^Xm       , Ql          , Rd          , Gs^Fp       , Gs^Fp       , Aa^Vha      , Aa^Fpa      , Aa^Fpa      , Aa^Fpa      , Aa^Fpa      , Mm^Xm       , Mm^Xm       
Mm^Xm       , Mm^Xm       , Mm          , Mm          , Rr          , Rr          , Rr          , Ch          , Kh          , Ch          , Rr          , Rr          , Rr          , Rr          , Rr          , Rr          , Rr          , Qxu^Xo      , Qxu^Xo      , Gg          , Gg          , Gs^Fp       , Gs^Fp       , Gs^Fp       , Gs^Fp       , Gg          , Gg          , Gg          , Gg          , Gg          , Gg          , Gs^Fp       , Gs^Fp       , Gs^Fp       , Gs^Fp       , Gs^Fp       , Gs^Fp       , Rd          , Rd          , Gg          , Gg^Efm      , Gg          , Rd          , Rd          , Gs^Fp       , Gs^Fp       , Gs^Fp       , Mm^Xm       , Mm^Xm       , Ql          , Mm^Xm       , Mm^Xm       , Rd          , Gs^Fp       , Aa          , Aa^Fpa      , Aa          , Aa^Fpa      , Aa          , Aa^Fpa      , Mm^Xm       , Mm^Xm       
Mm          , Mm          , Mm          , Mm          , Rr          , Rr          , Rr          , Ch          , Ch          , Ch          , Rr          , Rr          , Rr          , Rr          , Rr          , Rr          , Rr          , Rr^Fi|      , Rr          , Qxu^Xo      , Qxu^Xo      , Gg          , Gg          , Gs^Fp       , Gg          , Gg          , Gg          , Gs^Fms      , Gs^Fms      , Chr         , Chr         , Gs^Fp       , Gs^Fp       , Gs^Fp       , Gs^Fp       , Gs^Fp       , Gg          , Gg          , Gg          , Rd          , Rd          , Gg^Efm      , Rd          , Gs^Fp       , Gs^Fp       , Gg^Vh       , Gs^Fp       , Mm^Xm       , Mm^Xm       , Mm^Xm       , Mm^Xm       , Ha          , Aa          , Rd          , Rd          , Aa^Fpa      , Aa          , Aa          , Aa          , Aa          , Aa          , Mm^Xm       
Mm          , Mm^Xm       , Mm^Xm       , Ch          , Ch          , Rr          , Rr          , Rr          , Rr          , Rr          , Ch          , Rr          , Ch          , Ch          , Qxu^Xo      , Rr^Fi|      , Rr          , Rr          , Rr          , Rr^Fi|      , Rr          , Qxu^Xo      , Qxu^Xo      , Gg          , Gg          , Gs^Fms      , Gg          , Gg          , Gs^Fms      , Gs^Fms      , Gg^Fet      , Gs^Fp       , Gs^Fp       , Gg^Ve       , Gs^Fp       , Gs^Fp       , Gs^Fp       , Gg          , Gg          , Gg          , Gg          , Rd          , Rb          , Gs^Fp       , Gs^Fp       , Gs^Fp       , Mm^Xm       , Mm          , Mm^Xm       , Mm^Xm       , Mm^Xm       , Mm^Xm       , Aa          , Aa          , Aa          , Rd          , Aa          , Aa          , Aa^Fpa      , Aa^Fpa      , Aa^Fpa      , Mm^Xm       
Mm^Xm       , Mm^Xm       , Mm^Xm       , Qxe         , Gg          , Ch          , Ch          , Ch          , Ch          , Ch          , Mm^Xm       , Ch          , Gg          , Gg^Efm      , Gg          , Qxu^Xo      , Qxu^Xo      , Rr^Fi|      , Rr          , Rr          , Rr          , Rr^Fi|      , Rr          , Qxu^Xo      , Qxu^Xo      , Gg          , Gg          , Gg          , Gg          , Chr         , Gg          , Chr         , Gg          , Gs^Fp       , Gs^Fp       , Gs^Fp       , Gs^Fp       , Gg          , Gg          , Gg^Vh       , Co          , Rd          , Rd          , Gs^Fp       , Gs^Fp       , Gs^Fp       , Mm^Xm       , Mm^Xm       , Mm^Xm       , Mm^Xm       , Mm^Xm       , Mm^Xm       , Aa^Fpa      , Aa          , Aa          , Rd          , Aa          , Aa^Fpa      , Aa^Fpa      , Aa^Fpa      , Gs^Fp       , Mm^Xm       
Mm^Xm       , Mm^Xm       , Mm^Xm       , Mm^Xm       , Gg          , Gg          , Gs          , Rd          , Gg          , Gg          , Gg          , Gg          , Gg          , Gg          , Gg          , Gg          , Gg          , Qxu^Xo      , Qxu^Xo      , Rr^Fi|      , Rr          , Rr          , Rr          , Rr^Fi|      , Rr          , Qxu^Xo      , Qxu^Xo      , Gg          , Gg          , Gs^Fms      , Gg          , Gg          , Gs^Fp       , Gs^Fp       , Gs^Fp       , Gs^Fp       , Gs^Fp       , Gg          , Co          , Gg          , Co          , Co          , Rd          , Gs^Fp       , Gs^Fp       , Gs^Fp       , Mm^Xm       , Mm^Xm       , Mm^Xm       , Mm^Xm       , Aa^Fpa      , Aa^Fpa      , Aa^Fpa      , Aa^Fpa      , Aa          , Rd          , Aa          , Aa^Fpa      , Aa^Fpa      , Aa^Vea      , Mm^Xm       , Mm^Xm       
Mm^Xm       , Mm^Xm       , Gg^Efm      , Gg^Efm      , Gs          , Gs          , Gs          , Rd          , Gg^Fet      , Gg          , Gg          , Hh          , Hh          , Hh          , Hh          , Gg^Fet      , Gg          , Gg          , Mm^Xm       , Qxu^Xo      , Qxu^Xo      , Rr^Fi|      , Rr          , Rr          , Rr          , Rr^Fi|      , Rr          , Qxu^Xo      , Qxu^Xo      , Gg          , Gg          , Gs^Fp       , Gs^Fp       , Gs^Fp       , Gs^Fp       , Gs^Fp       , Gg          , Gg          , Co          , Co          , 3 Ko        , Co          , Co          , Co          , Gs^Fp       , Mm^Xm       , Mm^Xm       , Mm^Xm       , Mm^Xm       , Aa^Fpa      , Aa^Fpa      , Aa^Fpa      , Aa^Fpa      , Aa^Fpa      , Aa          , Rd          , Rd          , Aa          , Aa^Fpa      , Aa^Fpa      , Mm^Xm       , Mm^Xm       
Mm^Xm       , Mm^Xm       , Gg          , Gg          , Gg          , Gs          , Rd          , Rd          , Gg          , Gg^Fet      , Hh          , Hh^Vhh      , Hh          , Hh          , Hh          , Gg          , Mm^Xm       , Mm^Xm       , Mm          , Mm^Xm       , Mm^Xm       , Qxu^Xo      , Qxu^Xo      , Rr^Fi|      , Rr          , Rr          , Rr          , Rr^Fi|      , Rr          , Qxu^Xo      , Qxu^Xo      , Gs^Fp       , Gs^Fp       , Gs^Fp       , Gs^Fp       , Gg          , Qxu^Xo      , Qxu^Xo      , Qxu^Xo      , Co          , Rb          , Rd          , Co          , Co          , Mm^Xm       , Mm^Xm       , Mm^Xm       , Mm^Xm       , Rb          , Aa^Fpa      , Aa^Fpa      , Aa^Fpa      , Aa^Fpa      , Aa^Fpa      , Aa          , Aa          , Rd          , Aa^Fpa      , Aa^Fpa      , Aa^Fpa      , Mm^Xm       , Mm^Xm       
Mm^Xm       , Mm^Xm       , Gg          , Gg          , Gg^Fet      , Gs          , Rd          , Gg          , Gs          , Gg^Efm      , Gg          , Hh          , Hh          , Hh          , Mm^Xm       , Mm^Xm       , Mm^Xm       , Mm          , Mm          , Mm^Vhh      , Mm          , Mm          , Mm          , Qxu^Xo      , Qxu^Xo      , Rr^Fi|      , Rr          , Rr          , Rr          , Rr^Fi|      , Rr          , Qxu^Xo      , Qxu^Xo      , Gs^Fp       , Qxu^Xo      , Qxu^Xo      , Rr          , Rr^Fi|      , Rr          , Qxu^Bs/     , Qxu^Xo      , Gs^Fp       , Mm^Xm       , Mm^Xm       , Mm^Xm       , Mm^Xm       , Mm^Xm       , Mm^Xm       , Ai          , Rd          , Rd          , Aa^Fpa      , Rd          , Aa^Fpa      , Rd          , Rd          , Rd          , Aa^Fpa      , Aa^Fpa      , Aa^Fpa      , Mm^Xm       , Mm^Xm       
Mm^Xm       , Gg          , Gg          , Gg^Efm      , Gg          , Gg^Efm      , Rd          , Gg          , Gs          , Gs          , Gg^Fet      , Gg          , Mm^Xm       , Mm^Xm       , Mm^Xm       , Mm^Xm       , Wwr         , Mm          , Mm          , Mm          , Mm          , Mm          , Mm          , Mm          , Gg          , Qxu^Xo      , Qxu^Xo      , Rr^Fi|      , Rr          , Rr          , Rr          , Rr^Fi|      , Rr          , Qxu^Xo      , Rr          , Rr^Fi|      , Rr          , Rr          , Rr          , Rr^Fi|      , Qxu^Xo      , Qxu^Xo      , Aa^Fpa      , Mm^Xm       , Mm^Xm       , Mm^Xm       , Ai          , Ai          , Ai          , Ai          , Aa^Fpa      , Rd          , Aa^Fpa      , Rd          , Aa^Fpa      , Aa^Fpa      , Aa          , Rd          , Ha          , Ha          , Mm^Xm       , Mm^Xm       
Mm^Xm       , Gg          , Gg          , Gg          , Gg          , Rd          , Gg          , Gg          , Gg^Efm      , Gs          , Gg          , Mm^Xm       , Mm^Xm       , Mm^Xm       , Mm^Xm       , Mm^Xm       , Ww          , Ww          , Chw         , Chr         , Chr         , Mm          , Gg          , Mm          , Gs^Fp       , Gs^Fp       , Gs^Fp       , Qxu^Xo      , Qxu^Xo      , Rr^Fi|      , Rr          , Rr          , Tf          , Rr^Fi|      , Tf          , Rr          , Rr          , Rr^Fi|      , Qxu^Xo      , Qxu^Xo      , Aa^Fpa      , Aa^Fpa      , Aa^Fpa      , Aa^Fpa      , Aa^Fpa      , Aa^Fpa      , Aa^Fpa      , Aa^Fpa      , Rd          , Rb          , Aa^Fpa      , Aa^Fpa      , Aa^Fpa      , Aa^Fpa      , Aa^Fpa      , Aa^Fpa      , Aa          , Rd          , Ha          , Ha          , Mm^Xm       , Mm^Xm       
Mm^Xm       , Mm^Xm       , Gg          , Gg^Fet      , Rd          , Rd          , Gg          , Gg^Efm      , Gg          , Gg          , Gg          , Mm^Xm       , Mm^Xm       , Mm^Xm       , Wwr         , Ww          , Ww          , Ww          , Chw         , Chr         , Chr         , Gg          , Gg^Efm      , Gg          , Gg          , Gs^Fp       , Gs^Fp       , Gs^Fp       , Qxu^Xo      , Qxu^Xo      , Rr          , Rr^Fi|      , Tf          , Tf          , Tf          , Rr^Fi|      , Rr          , Qxu^Xo      , Qxu^Xo      , Aa^Fpa      , Aa^Fpa      , Aa^Fpa      , Aa^Fpa      , Aa^Vea      , Aa^Fpa      , Aa^Fpa      , Aa^Fpa      , Aa^Fpa      , Rd          , Aa^Fpa      , Aa^Fpa      , Aa^Fpa      , Aa^Vea      , Aa^Fpa      , Aa^Fpa      , Aa          , Aa          , Rd          , Ha          , Aa^Fpa      , Mm^Xm       , Mm^Xm       
Mm^Xm       , Gg          , Gg          , Rd          , Rd          , Rd          , Gg          , Gs^Fp       , Gs^Fp       , Sm          , Mm^Xm       , Mm^Xm       , Mm^Xm       , Mm^Xm       , Wo          , Wo          , Ww          , Chw         , Chw         , 7 Khr       , Rp          , Rp          , Gg          , Gg          , Gs^Fp       , Gs^Fp       , Qxu^Xo      , Qxu^Xo      , Rr          , Rr^Fi|      , Rr          , Rr          , Rr          , Rr^Fi|      , Rr          , Rr          , Rr          , Rr^Fi|      , Rr          , Qxu^Xo      , Qxu^Xo      , Aa^Fpa      , Aa^Fpa      , Aa^Fpa      , Aa^Fpa      , Aa^Fpa      , Aa^Fpa      , Aa^Fpa      , Rd          , Aa^Fpa      , Aa^Fpa      , Aa^Fpa      , Aa          , Aa^Fpa      , Aa          , Coa         , Rd          , Rd          , Ha          , Aa^Fpa      , Mm^Xm       , Mm^Xm       
Mm^Xm       , Mm^Xm       , Gg          , Rd          , Gs^Fp       , Gs^Fp       , Gs^Fp       , Gs^Fp       , Aa^Fpa      , Gs^Fp       , Mm^Xm       , Mm^Xm       , Wo          , Wo          , Wo          , Ww          , Ww          , Chw         , Wwr         , Rp          , Rp          , Gg          , Gg^Efm      , Gg          , Gg^Vh       , Qxu^Xo      , Qxu^Xo      , Rr^Fi|      , Rr          , Rr          , Rr          , Rr^Fi|      , Qxu^Xo      , Qxu^Xo      , Qxu^Xo      , Rr^Fi|      , Rr          , Rr          , Rr          , Rr^Fi|      , Rr          , Qxu^Xo      , Qxu^Xo      , Aa^Fpa      , Aa^Fpa      , Aa^Fpa      , Aa          , Aa^Fpa      , Rd          , Aa^Fpa      , Aa^Fpa      , Aa^Fpa      , Aa          , Aa          , Chr         , Chr         , Chr         , Cea         , Ha          , Aa^Fpa      , Mm^Xm       , Mm^Xm       
Mm^Xm       , Mm^Xm       , Gg^Efm      , Rd          , Gg          , Gs^Fp       , Aa^Fpa      , Aa^Fpa      , Aa^Fpa      , Mm^Xm       , Mm^Xm       , Mm^Xm       , Wo          , Wo          , Wo          , Ww          , Ww          , Ww          , Gg^Efm      , Gg          , Rp          , Gs          , Gs          , Gg          , Gg^Efm      , Gg          , Rp          , Qxu^Bs/     , Qxu^Xo      , Rr^Fi|      , Qxu^Xo      , Qxu^Xo      , Gs^Fp       , Gs^Fp       , Gs^Fp       , Qxu^Xo      , Qxu^Xo      , Rr^Fi|      , Rr          , Rr          , Rr          , Rr^Fi|      , Rr          , Qxu^Xo      , Qxu^Xo      , Aa          , Rd          , Rd          , Aa^Fpa      , Rd          , Rd          , Aa^Fpa      , Aa          , Coa         , Chr         , 6 Kea       , Ce          , Rd          , Ha          , Aa^Fpa      , Mm^Xm       , Xuc         
Mm^Xm       , Mm^Xm       , Gg          , Rd          , Gg          , Gs^Fp       , Aa^Fpa      , Aa^Fpa      , Mm^Xm       , Mm^Xm       , Mm^Xm       , Wo          , Wo          , Wo          , Wo          , Ww          , Gg^Fet      , Gg          , Gs          , Gg          , Rp          , Gs          , Gg          , Gg          , Rp          , Rp          , Gs^Fp       , Gs^Fp       , Gs^Fp       , Qxu^Xo      , Gs^Fp       , Gs^Fp       , Gs^Fp       , Gs^Fp       , Gs^Fp       , Gs^Fp       , Gs^Fp       , Qxu^Xo      , Qxu^Xo      , Rr^Fi|      , Rr          , Rr          , Rr          , Rr^Fi|      , Rr          , Qxu^Xo      , Qxu^Xo      , Aa          , Aa          , Aa^Fpa      , Aa^Fpa      , Rd          , Rd          , Aa          , Ce          , Ai          , Xuc         , Rd          , Xuc         , Xuc         , Xuc         , Xuc         
Mm^Xm       , Mm^Xm       , Ha          , Rd          , Rd          , Gs^Fp       , Ha          , Aa^Fpa      , Mm^Xm       , Mm^Xm       , Mm^Xm       , Wo          , Wo          , Wo          , Ww          , Ww          , Gg^Vh       , Gs          , Gg^Efm      , Gg          , Rp          , Gs          , Rp          , Rp          , Hh          , Rd          , Rd          , Gs^Fp       , Gs^Fp       , Gs^Fp       , Gs^Fp       , Gs^Fp       , Gs^Fp       , Gs^Fp       , Gs^Fp       , Gs^Fp       , Gs^Fp       , Mm          , Mm          , Qxu^Xo      , Qxu^Xo      , Rr^Fi|      , Rr          , Rr          , Rr          , Rr^Fi|      , Rr          , Qxu^Xo      , Qxu^Xo      , Aa          , Aa          , Aa^Fpa      , Aa          , Rd          , Xuc         , Xuc         , Ha          , Xuc         , Ha          , Ha          , Gg^Efm      , Mm^Xm       
Mm^Xm       , Ha          , Aa^Fpa      , Gg          , Rd          , Gg          , Ha          , Ha^Vhha     , Mm^Xm       , Mm^Xm       , Mm^Xm       , Wo          , Wo          , Wo          , Ww          , Ww          , Gg^Efm      , Gg          , Gg          , Gg^Fet      , Rp          , Rp          , Hh          , Hh          , Hh          , Rd          , Rd          , Gs^Fp       , Gs^Fp       , Gs^Fp       , Gs^Fp       , Gs^Fp       , Gs^Fp       , Gs^Fp       , Gs^Fp       , Gs^Fp       , Gs^Fp       , Mm          , Mm          , Mm          , Mm          , Qxu^Xo      , Qxu^Xo      , Rr^Fi|      , Rr          , Rr          , Rr          , Rr^Fi|      , Rr          , Qxu^Xo      , Qxu^Xo      , Aa          , Xuc         , Xuc         , Ha          , Ha          , Ha          , Rd          , Aa^Fpa      , Aa^Fpa      , Mm          , Mm^Xm       
Mm^Xm       , Ha          , Ha          , Ha          , Rb          , Rd          , Ha          , Ha          , Gg          , Mm^Xm       , Mm^Xm       , Wo          , Wo          , Wo          , Ww          , Ww          , Gg          , Gg^Fet      , Rp          , Rp          , Hh          , Hh          , Hh          , Hh          , Hh          , Hh          , Hh          , Rd          , Rd          , Gs^Fp       , Rd          , Gs^Fp       , Gs^Fp       , Gs^Fp       , Gs^Fp       , Gs^Fp       , Gs^Fp       , Gs^Fp       , Mm          , Mm          , Mm          , Mm          , Mm          , Qxu^Xo      , Qxu^Xo      , Rr^Fi|      , Rr          , Rr          , Rr          , Rr^Fi|      , Rr          , Qxu^Xo      , Qxu^Xo      , Xuc         , Ha          , Ha          , Ch          , Rd          , Gs^Fp       , Mm          , Mm^Xm       , Mm          
Mm^Xm       , Aa^Vea      , Gg          , Sm          , Rd          , Rd          , Ha          , Ha          , Mm^Xm       , Mm^Xm       , Mm^Xm       , Wo          , Wo          , Wo          , Ww          , Ww          , Gg          , Rp          , Hh          , Hh          , Mm          , Mm          , Mm          , Hh          , Hh          , Hh          , Hh          , Hh          , Hh          , Rd          , Rd          , Rd          , Rd          , Gs^Fp       , Gs^Fp       , Gs^Fp       , Mm          , Mm          , Mm          , Mm          , Mm          , Mm          , Mm          , Mm^Vhh      , Mm          , Qxu^Xo      , Qxu^Xo      , Rr^Fi|      , Rr          , Rr          , Rr          , Rr^Fi|      , Rr          , Qxu^Xo      , Ch          , Ch          , Rr          , Ch          , Mm^Xm       , Mm^Xm       , Mm          , Mm^Xm       
Mm^Xm       , Mm^Xm       , Mm          , Rd          , Ha          , Ha          , Ai          , Mm^Xm       , Ai          , Mm^Xm       , Mm^Xm       , Mm^Xm       , Wo          , Wwr         , Wwf         , Gg          , Rp          , Rp          , Hh          , Hh          , Mm          , Mm          , Mm          , Mm          , Mm          , Mm          , Hh          , Hh^Vhh      , Hh          , Hh          , Hh          , Hh          , Hh          , Rd          , Gg          , Gg^Efm      , Gg          , Mm          , Mm          , Mm          , Mm          , Mm          , Hh          , Chr         , Hh          , Mm          , Ce          , Qxu^Xo      , Qxu^Xo      , Rr^Fi|      , Rr          , Rr          , Rr          , Rr          , Rr          , Rr          , Mm^Xm       , Mm^Xm       , Mm^Xm       , Mm^Xm       , Gg          , Mm          
Mm^Xm       , Mm          , Mm          , Mm          , Mm          , Ha          , Wo          , Ai          , Ww          , Wo          , Mm^Xm       , Mm^Xm       , Wwf         , Wwf         , Wwf         , Rp          , Hh          , Hh          , Hh          , Hh          , Mm          , Mm          , Mm          , Mm          , Mm          , Hh          , Mm          , Hh          , Hh          , Hh          , Hh          , Hh          , Hh          , Rd          , Rd          , Gg^Efm      , Gg^Fet      , Mm          , Mm          , Mm          , Mm          , Mm          , Chr         , Ce          , 5 Ket       , Ce          , Xuc         , Xuc         , Xuc         , Qxu^Xo      , Ch          , Rr          , Rr          , Rr          , Rr          , Rr          , Rr          , Rr          , Gg          , Gg          , Gs^Fp       , Gg          
Mm          , Mm          , Chr         , Mm          , Ds          , Wo          , Wo          , Wo          , Wwf         , Wwf         , Wwf         , Wwf         , Wwf         , Wwf         , Wwf         , Hh          , Hh          , Hh          , Hh          , Mm          , Mm          , Mm          , Mm          , Mm          , Mm          , Mm          , Mm          , Mm          , Mm          , Hh          , Hh          , Hh          , Hh          , Gg          , Gg          , Rd          , Rd          , Rd          , Rd          , Mm          , Mm          , Mm          , Mm          , Chr         , Ce          , Xuc         , Ha          , Ha          , Ch          , Ch          , Rr          , Rr          , Mm^Xm       , Rr          , Rr          , Rr          , Rr          , Rr          , Rr          , Gg^Efm      , Gg^Fet      , Gg          
Mm          , Mm          , Chr         , Hh          , Chr         , Chs         , Chr         , Wo          , Wwf         , Wwf         , Ww          , Wwf         , Ww          , Wwf         , Wwf         , Hh          , Mm^Xm       , Hh          , Mm          , Mm          , Mm          , Mm          , Mm          , Mm          , Mm^Vhh      , Mm          , Mm          , Mm          , Mm          , Mm          , Hh          , Hh          , Mm          , Gg^Efm      , Gg^Efm      , Gg          , Mm          , Rd          , Rd          , Rd          , Rd          , Mm          , Rd          , Ce          , Hh          , Xuc         , Ha          , Ha          , Rb          , Ch          , Mm^Xm       , Mm^Xm       , Mm^Xm       , Rr          , Gs^Fp       , Rr          , Rr          , Rr          , Rr          , Rr          , Rr          , Gg          
Mm          , Chr         , Chr         , Chr         , Chr         , Mm          , Mm          , Mm          , Mm          , Wwr         , Ww          , Ww          , Wo          , Ww          , Ww          , Mm^Xm       , Mm^Xm       , Mm^Xm       , Mm^Xm       , Wwr         , Mm          , Mm          , Mm          , Mm          , Mm          , Mm          , Mm          , Mm          , Mm          , Mm          , Mm          , Mm          , Mm          , Gg^Efm      , Gg          , Gg^Fet      , Mm          , Mm          , Mm          , Mm          , Mm          , Rd          , Mm          , Chr         , Rd          , Xuc         , Rd          , Rd          , Ha          , Aa^Fpa      , Mm          , Mm^Xm       , Mm^Xm       , Gs^Fp       , Gs^Fp       , Gg^Efm      , Gg^Efm      , Rr          , Rr          , Rr          , Rr          , Rr          
Mm          , Mm          , Chr         , 4 Khr       , Chr         , Chr         , Mm          , Mm^Vhh      , Mm^Xm       , Mm^Xm       , Mm^Xm       , Mm^Xm       , Wo          , Ww          , Ww          , Ww          , Ww          , Ww          , Ww          , Ww          , Mm          , Mm          , Mm          , Mm^Xm       , Mm^Xm       , Mm          , Mm^Xm       , Mm          , Mm^Xm       , Mm          , Mm^Xm       , Mm          , Mm^Xm       , Mm          , Mm^Xm       , Mm          , Mm          , Mm          , Mm          , Mm          , Mm^Xm       , Mm          , Mm          , Mm          , Xuc         , Xuc         , Ha          , Ha          , Aa^Fpa      , Aa^Fpa      , Mm^Xm       , Mm^Xm       , Mm          , Gs^Fp       , Gg^Efm      , Gg^Efm      , Gg          , Gg          , Gg          , Rr          , Rr          , Rr          
Mm          , Mm          , Mm          , Mm          , Mm          , Mm          , Mm          , Mm          , Mm^Xm       , Mm^Xm       , Mm^Xm       , Wo          , Wo          , Wo          , Ww          , Wo          , Wo          , Mm^Xm       , Mm^Xm       , Mm^Xm       , Mm^Xm       , Mm^Xm       , Mm^Xm       , Mm^Xm       , Mm^Xm       , Mm^Xm       , Mm^Xm       , Mm^Xm       , Mm^Xm       , Mm^Xm       , Mm^Xm       , Mm^Xm       , Mm^Xm       , Mm^Xm       , Mm          , Mm^Xm       , Mm^Xm       , Mm^Xm       , Mm^Xm       , Mm^Xm       , Mm^Xm       , Mm^Xm       , Mm^Xm       , Mm^Xm       , Mm^Xm       , Mm^Xm       , Mm^Xm       , Mm^Xm       , Mm^Xm       , Mm^Xm       , Mm^Xm       , Mm^Xm       , Mm^Xm       , Gg          , Gg          , Gg^Fet      , Gg          , Hh          , Gg          , Gs^Fp       , Gg          , Rr          
