Aa^Fpa, Aa, Aa^Fpa, Aa, Re, Aa, Aa, Aa, Aa, Ai, Wo, Ai, Ai, Ai, Wo, Wo, Wo, Wo, Wo, Wo, Wo, Aa, Aa, Wo, Wo, Wo, Wo, Wo, Ai, Ms^Xm, Ms^Xm, Ms^Xm, Aa^Fpa, Aa, Aa, Aa, Re
Aa^Fpa, Aa^Fpa, Ha^Vca, Aa, Re, Chr, Chr, Chr, Aa, Aa^Vha, Wo, Ai, Ai, Wo, Wo, Wo, Wo, Wo, Wo, Aa, 5 Khw, Cme, Aa^Fpa, Wo, Wo, Wo, Wo, Wo, Ai, Ms^Xm, Ms^Xm, Ms^Xm, Aa^Fpa, Aa, Aa^Vea, Re, Aa
Aa^Fpa, Aa^Fpa, Aa^Fpa, Aa^Fpa, Re, Chr, 1 Khr, Chr, Aa, Wo, Ai, Ai, Wo, Wo, Wo, Wo, Wo, Wo, Wo, Aa^Fpa, Aa, Cme, Aa, Wo, Wo, Wo, Ai, Ai, Wo, Ms^Xm, Ms^Xm, Ms^Xm, Ms, Aa^Fpa, Aa, Re, Aa^Em
Aa^Em, Aa^Fpa, Aa^Fpa, Aa^Fpa, Aa^Fpa, Re, Aa, Chr, Aa^Fpa, Aa, Ai, Ai, Ai, Wo, Wo, Wo, Wo, Wo, Wo, Aa^Vha, Wo, Aa, Wo, Wo, Wo, Wo, Ai, Wo, Wo, Aa, Aa, Ms^Xm, Ms^Xm, Aa^Fpa, Aa^Fpa, Re, Aa
Aa, Aa^Fpa, Ha, Aa^Fpa, Aa^Fpa, Re, Aa^Fpa, Aa^Ecf, Aa^Fpa, Aa, Wo, Ai, Wo, Wo, Wo, Wo, Wo, Wo, Wo, Wo, Wo, Wo, Wo, Wo, Wo, Wo, Wo, Ai, Aa, Aa, Aa^Fpa, Ms^Xm, Ms^Xm, Aa^Fpa, Aa, Re, Aa
Aa, Aa^Fpa, Ha^Vhha, Ha, Aa^Fpa, Re, Aa^Fpa, Aa, Aa^Em, Aa^Fpa, Wo, Ai, Ai, Wo, Wo, Wo, Wo, Wo, Wo, Wo, Wo, Wo, Wo, Wo, Wo, Ai, Aa, Aa, Aa, Aa^Fpa, Aa, Ms, Cha, Ms^Xm, Ms^Xm, Re, Aa
Aa, Aa^Fpa, Ha, Ha, Ha, Re, Re, Aa, Aa^Fpa, Aa, Aa, Ai, Ai, Wo, Wo, Wo, Wo, Wo, Wo, Wo, Wo, Wo, Wo, Wo, Ai, Ai, Aa, Aa^Fpa, Aa^Fpa, Aa^Fpa, Aa, Cha, Cha, Ms, Re, Re, Aa
Aa, Ha, Ha, Ha, Ha, Ha, Re, Aa, Aa^Fpa, Aa^Fpa, Aa^Fpa, Ai, Ai, Ai, Wo, Wo, Wo, Wo, Wo, Wo, Wo, Wo, Wo, Wo, Wo, Wo, Aa^Fpa, Aa^Fpa, Aa^Fpa, Aa, Aa, Cha, 8 Kha, Cha, Re, Ms^Xm, Aa
Aa, Ha, Ha, Ha, Ha, Ha, Ha, Re, Aa, Aa^Fpa, Aa^Fpa, Aa, Aa, Ai, Wo, Wo, Wo, Wo, Wo, Wo, Wo, Wo, Wo, Ai, Ai, Aa, Aa^Fpa, Aa^Fpa, Aa^Fpa, Aa, Aa, Cha, Cha, Cha, Re, Ms^Xm, Aa
Re, Re, Re, Ha, Ha, Ha^Vhha, Re, Re, Cea, Aa, Aa^Feta, Aa, Ai, Ai, Wo, Wo, Wo, Wo, Wo, Wo, Wo, Wo, Wo, Ai, Ai, Aa, Aa^Fpa, Aa, Aa, Aa, Aa^Vca, Aa, Re, Re, Ms^Xm, Ms^Xm, Aa
Aa, Aa, Aa^Em, Re, Re, Re, Re, Cea, 3 Kea, Cea, Wo, Wo, Ai, Wo, Wo, Wo, Wo, Wo, Wo, Wo, Wo, Wo, Wo, Wo, Wo, Aa, Aa, Aa, Aa, Aa^Em, Aa, Aa, Re, Ms, Ms, Ms, Aa
Aa, Aa, Aa^Fpa, Aa^Em, Aa, Aa, Re, Cea, Cea, Cea, Wo, Ai, Wo, Wo, Wo, Wo, Wo, Wo, Wo, Wo, Wo, Wo, Wo, Ai, Ai, Aa, Aa, Aa, Aa^Fpa, Aa, Aa, Re, Ai, Ai, Ai, Ms^Xm, Aa
Aa, Aa, Aa^Fpa, Aa^Fpa, Aa^Fpa, Aa^Fpa, Aa^Ecf, Re, Ai, Ai, Ai, Ai, Ai, Wo, Wo, Wo, Wo, Wo, Wo, Wo, Wo, Wo, Wo, Ai, Wo, Aa, Aa, Aa^Fpa, Aa^Fpa, Aa, Aa, Re, Ai, Ai, Ai, Ai, Aa
Aa, Aa, Chr, Chr, Chr, Aa, Re, Re, Ai, Ai, Ai, Wo, Wo, Wo, Wo, Wo, Wo, Wo, Wo, Wo, Wo, Wo, Ai, Ai, Aa, Aa, Aa, Aa^Fpa, Re, Aa, Re, Re, Re, Ai, Re, Re, Aa
Aa, Aa, Chr, 4 Kte, Chr, Aa, Re, Ai, Ai, Ai, Ai, Ai, Wo, Ai, Wo, Wo, Wo, Wo, Wo, Wo, Wo, Wo, Ai, Wo, Ai, Re, Re, Re, Aa^Fpa, Re, Re, Aa^Em, Aa, Re, Aa, Aa, Aa
Aa, Aa^Fpa, Aa^Fpa, Chr, Aa^Fpa, Aa, Re, Ai, Ai, Ai, Ai, Ai, Ai, Ai, Ai, Ai, Wo, Wo, Wo, Wo, Wo, Wo, Wo, Ai, Ai, Aa^Vha, Aa, Aa, Aa^Fpa, Aa^Fpa, Re, Aa, Aa, Aa, Aa^Fpa, Aa^Fpa, Aa
Aa^Fpa, Aa^Em, Aa^Fpa, Aa^Vca, Ai, Aa, Re, Ai, Aa, Ai, Ai, Ai, Rra^Vhca, Wo, Ai, Wo, Wo, Wo, Wo, Wo, Wo, Wo, Wo, Ai, Ai, Aa, Aa, Aa^Fpa, Aa^Fpa, Aa^Fpa, Re, Coa, Coa, Aa, Aa^Fpa, Aa^Fpa, Aa
Aa^Fpa, Aa, Aa, Ai, Ai, Ai, Aa, Re, Aa, Aa, Aa, Aa, Rra, Re, Wo, Wo, Wo, Wo, Wo, Wo, Wo, Wo, Wo, Wo, Ai, Ai, Aa, Aa^Fpa, Aa^Fpa, Aa^Fpa, Re, Coa, Coa, Aa, Aa, Aa, Aa
Aa, Aa^Fpa, Aa^Em, Aa, Aa, Ai, Aa, Re, Re, Re, Re, Re, Aa^Fpa, Aa^Fpa, Ai, Wo, Wo, Wo, Wo, Wo, Wo, Wo, Wo, Wo, Ai, Ai, Ai, Aa, Aa, Aa, Re, 7 Koa, Coa, Coa, Aa^Fpa, Aa^Em, Aa
Aa, Aa^Fpa, Aa^Fpa, Aa^Fpa, Aa, Aa, Aa, Re, Re, Aa, Aa^Em, Aa^Fpa, Aa^Fpa, Aa, Wo, Wo, Wo, Wo, Wo, Wo, Wo, Wo, Wo, Wo, Wo, Ai, Aa^Em, Aa, Aa^Vha, Aa, Re, Coa, Coa, Aa^Fpa, Aa^Fpa, Aa^Fpa, Aa
Aa, Aa^Fpa, Aa, Aa, Aa^Fpa, Aa, Re, Re, Ai, Ai, Aa^Fpa, Aa^Fpa, Aa^Em, Aa, Ai, Wo, Wo, Wo, Wo, Wo, Wo, Wo, Wo, Wo, Wo, Ai, Aa, Aa, Aa^Fpa, Aa, Aa, Re, Aa, Aa^Fpa, Ha, Ha, Aa
Aa, Aa^Fpa, Aa, Aa, Re, Re, Aa, Aa^Vha, Ai, Ai, Aa^Fpa, Aa^Fpa, Ai, Wo, Ai, Wo, Wo, Wo, Wo, Wo, Wo, Wo, Wo, Wo, Wo, Ai, Aa, Aa, Aa^Fpa, Aa^Fpa, Aa, Re, Aa, Aa^Fpa, Ha, Ha, Aa
Aa, Aa, Aa, Aa, Re, Re, Aa, Aa, Aa, Aa, Aa, Aa, Ai, Ai, Wo, Wo, Wo, Wo, Wo, Wo, Aa, Wo, Wo, Wo, Wo, Ai, Aa, Aa^Fpa, Aa^Fpa, Aa^Fpa, Aa, Re, Aa^Em, Aa, Ha, Ha, Ha
Aa, Aa, Aa, Aa^Vha, Re, Re, 2 Kha, Chr, Chr, Aa, Aa^Vca, Ai, Ai, Wo, Wo, Wo, Wo, Wo, Wo, 6 Khw, Cme, Aa, Wo, Wo, Wo, Wo, Aa, Aa, Aa^Fpa, Aa^Fpa, Aa, Re, Re, Aa, Ms, Ms^Xm, Ms
Aa, Aa^Fpa, Aa^Fpa, Aa, Re, Re, Chr, Chr, Chr, Aa, Ai, Ai, Wo, Wo, Wo, Wo, Wo, Wo, Wo, Cme, Aa, Aa^Fpa, Wo, Wo, Wo, Wo, Wo, Aa, Aa, Aa^Fpa, Aa, Aa^Voa, Re, Ha, Ha, Ms, Ha
Aa, Aa^Fpa, Aa^Fpa, Aa^Em, Re, Re, Aa^Fpa, Chr, Aa, Ai, Wo, Wo, Wo, Wo, Wo, Wo, Wo, Wo, Aa, Aa^Vea, Aa, Aa^Fpa, Aa, Wo, Wo, Wo, Wo, Ai, Wo, Aa, Aa, Aa, Re, Ha, Ha, Ha, Ha
Aa, Aa^Fpa, Aa, Aa^Fpa, Re, Re, Aa, Aa, Aa, Ai, Ai, Wo, Wo, Wo, Wo, Wo, Wo, Wo, Wo, Wo, Wo, Aa, Wo, Wo, Wo, Wo, Wo, Wo, Ai, Aa, Aa, Aa, Re, Ha, Aa, Ha, Aa
