Xu, Xu, Xu, Wog, Wog, Wog, Wog, Wog, Wog, Wog, Wwg, Wwg, Xu, Xu, Xu, Xu, Xu, Xu, Xu, Xu, Xu, Xu, Xu, Xu, Xu, Xu, Xu, Xu, Xu, Xu, Xu, Xu, Xu, Xu, Xu, Xu, Xu, Xu, Xu, Xu, Xu, Xu, Xu, Xu, Xu, Xu, Xu, Xu, Xu, Xu, Re, Re
Xu, Xu, Uu^Emf, Uu, Uu, Wwg^Vm, Wog, Wog, Wog, Wog, Wwrg, Wwg, Xu, Xu, Xu, Xu, Uu^Uf, Xu, Re, Uu^Uf, Xu, Xu, Xu, Xu, Xu, Xu, Uu^Vud, Xu, Xu, Xu, Xu, Xu, Qxu, Xu, Qxu, Xu, Xu, Xu, Xu, Xu, Xu, Xu, Xu, Xu, Xu, Xu, Xu, Xu, Xu, Re, Re, Xu
Xu, Uu^Em, Uu^Emf, Uu^Em, Uu, Uu, Wog, Wog, Wog, Wog, Wwg, Wwg, Xu, Xu, Xu, Xu, Re, Uu, Xu, Uu^Em, Uu, Xu, Xu, Xu, Xu, Xu, Re, Re, Uu^Uf, Uu^Vud, Re, Qxu, Xu, Qxu, Xu, Qxu, Qxu, Xu, Xu, Xu, Xu, Xu, Xu, Xu, Xu, Xu, Xu, Xu, Re, Re, Xu, Xu
Xu, Xu, Uu^Emf, Uu^Emf, Uu, Uu^Em, Xu, Wwg^Vm, Wog, Wog, Wwg, Wwg, Xu, Xu, Uu^Em, Re, Xu, Xu, Xu, Re, Re, Re, Re, Re, Uu^Em, Uu^Vu, Rd, Uu^Uf, Uu^Uf, Uu^Uf, Xu, Xu, Xu, Xu, Xu, Xu, Xu, Qxu, Qxu, Xu, Xu, Xu, Xu, Xu, Re, Re, Re, Re, Re, Xu, Xu, Xu
Xu, Xu, Uu, Uu^Em, Uu, Uu^Emf, Xu, Xu, Wog, Wog, Wwg, Xu, Xu, Uu^Uf, Uu, Xu, Xu, Xu, Xu, Xu, Xu, Xu, Uu^Vu, Re, Uu^Uf, Re, Rd, Uu^Uf, Xu, Qlf, Xu, Xu, Xu, Re, Xu, Xu, Re, Xu, Xu, Qxu, Uu, Re, Uu^Vu, Rd, Rd, Re, Re, Re, Xu, Xu, Xu, Xu
Xu, Xu, Xu, Uu, Xu, Xu, Xu, Xu, Wog, Wog, Wwg, Xu, Xu, Xu, Re, Re, Re, Re, Uu, Uu^Uf, Uu^Uf, Xu, Uu, Uu^Uf, Xu, Re, Uu^Vud, Rd, Xu, Qxu, Uu, Uu^Fetd, Uu^Em, Re, Re, Re, Xu, Re, Uu, Uu, Re, Re, Cud, Rd, Rd, Rd, Xu, Xu, Xu, Xu, Xu, Xu
Xu, Xu, Xu, Xu, Xu, Xu, Xu, Xu, Xu, Wwg, Wwg, Xu, Xu, Xu, Xu, Xu, Xu, Xu, Xu, Rd, Xu, Xu, Uu, Xu, Xu, Xu, Xu, Xu, Xu, Xu, Re, Re, Re, Re, Xu, Xu, Uu, Uu^Em, Uu^Uf, Re, Cud, Cud, Cud, Cud, Cud, Uu^Em, Uu^Uf, Xu, Xu, Xu, Xu, Xu
Xu, Xu, Xu, Xu, Xu, Xu, Xu, Xu, Xu, Wwg, Wwg, Xu, Re, Xu, Uu^Uf, Xu, Rd, Rd, Rd, Rd, Xu, Xu, Qxu, Qlf, Qxu, Xu, Xu, Uu^Vu, Rd, Rd, Xu, Xu, Xu, Xu, Xu, Xu, Uu^Em, Uu^Uf, Uu^Vu, Re, Cud, Cud, Cud, 5 Cud^Kov, Cud, Re, Uu^Uf, Xu, Xu, Xu, Xu, Xu
Xu, Xu, Xu, Xu, Xu, Xu, Xu, Xu, Rd, Xu, Wwg^Bw/r, Rd, Xu, Uu, Xu, Rd, Xu, Xu, Xu, Xu, Xu, Xu, Uu, Xu, Xu, Qxu, Uu, Re, Rd, Xu, Xu, Xu, Xu, Uu^Vu, Xu, Xu, Re, Uu^Uf, Uu^Em, Re, Re, Cud, Cud, Cud, Re, Uu^Em, Uu^Uf, Xu, Uh, Uh, Uu^Vud, Xu
Xu, Xu, Xu, Xu, Xu, Xu, Xu, Uu, Xu, Rd, Wwg, Wwg, Wwg, Xu, Xu, Uu^Em, Re, Xu, Xu, Xu, Rd, Rd, Xu, Xu, Xu, Re, Uu, Xu, Re, Xu, Xu, Xu, Xu, Re, Re, Xu, Xu, Re, Uu, Uu, Uu, Cud, Rd, Cud, Uu, Uu^Em, Xu, Xu, Uh, Xu, Xu, Xu
Xu, Xu, Xu, Xu, Re, Xu, Re, Re, Xu, Xu, Xu, Wwg, Wwg, Xu, Xu, Uu^Uf, Re, Xu, Re, Uu, Xu, Rd, Xu, Xu, Rd, Re, Uu^Vud, Xu, Re, Xu, Uu, Xu, Xu, Xu, Rd, Xu, Xu, Xu, Xu, Uu^Vud, Re, Rd, Re, Re, Uu^Vu, Re^Es, Uu, Xu, Xu, Uh, Xu, Xu
Xu, Xu, Xu, Re, Xu, Re, Xu, Re, Uu, Xu, Xu, Wwg, Wwg, Wwg, Xu, Xu, Xu, Re, Xu, Xu, Uu, Rd, Xu, Re, Rd, Xu, Xu, Xu, Uu, Uu, Xu, Uu, Xu, Xu, Xu, Re^Es, Xu, Xu, Qxu, Qxu, Qxu, Re, Xu, Re, Xu, Xu, Uu, Xu, Xu, Uh, Uh, Xu
Xu, Xu, Qlf, Qlf, Qlf^Bs/, Re, Re^Em, Xu, Re, Xu, Xu, Xu, Wwg, Wwg, Wwg, Xu, Xu, Xu, Xu, Uu^Uf, Uu^Uf, Rd, Re, Uu, Xu, Xu, Xu, Uu, Rd, Xu, Xu, Re, Xu, Xu, Uu, Uu, Xu, Qxu, Xu, Xu, Xu, Qxu, Xu, Uu, Uu, Xu, Uu, Uu, Xu, Uh, Xu, Xu
Xu, Xu, Qlf^Bs/, Qlf^Bs/, Qlf, Qlf, Qlf, Re, Xu, Re, Xu, Xu, Xu, Wwg, Wwg, Wwg, Wwg, Xu, Xu, Xu, Xu, Xu, Xu, Uu, Xu, Xu, Re, Rd, Xu, Xu, Rd, Re, Re^Es, Uu, Xu, Re, Xu, Qxu, Xu, Xu, Xu, Qxu, Xu, Xu, Xu, Uu, Xu, Rd, Uu, Uu, Xu, Xu
Xu, Re, Qlf, Qlf, Qlf, Qlf, Qlf^Bs/, Re, Xu, Re, Uu, Xu, Xu, Xu, Xu, Wwg, Wwg, Wwg, Wwg, Xu, Xu, Xu, Rd, Uu, Xu, Uu^Vud, Re, Xu, Xu, Uu, Uu, Xu, Xu, Xu, Xu, Xu, Uu, Qxu, Qxu, Xu, Qxu, Qxu, Xu, Uu^Vu, Uu, Xu, Xu, Uu, Uu, Xu, Xu, Xu
Xu, Re, Xu, Qlf, Qlf^Bs/, Qlf^Bs/, Qlf, Xu, Xu, Xu, Xu, Uu, Xu, Xu, Xu, Xu, Uu, Wwg, Wwg, Xu, Xu, Xu, Re, Xu, Xu, Xu, Xu, Xu, Xu, Xu, Xu, Xu, Xu, Xu, Uu, Uu, Uu, Uu, Uu^Fetd, Qxu, Qxu, Xu, Xu, Uu, Uu^Em, Xu, Xu, Xu, Uu, Xu, Xu, Xu
Xu, Re, Xu, Re, Re, Qlf, Xu, Xu, Uu^Vud, Xu, Uu^Em, Uu, Uu^Em, Xu, Xu, Xu, Uu, Uu^Fetd, Wwg, Wwg, Wwg^Bw/r, Re, Xu, Xu, Wog, Xu, Wog, Wog, Wwg^Vm, Xu, Wog, Wog, Wog, Sm, Xu, Uu, Xu, Uu, Uu, Uu, Xu, Xu, Uu, Xu, Xu, Uu^Uf, Xu, Uu, Rd, Xu, Xu, Xu
Xu, Re, Xu, Xu, Re, Xu, Xu, Xu, Uu, Uu, Re, Uu, Uu, Xu, Uu, Uu^Vu, Uu, Re, Wwg^Bw/r, Wwg^Bw/r, Wwg, Uu^Vud, Xu, Xu, Wog, Wwg^Vm, Wog, Wog, Wog, Wog, Wog, Wwg^Vm, Xu, Xu, Xu, Xu, Xu, Xu, Xu, Uu, Uu, Uu^Uf, Xu, Uu, Uu^Em, Uu^Uf, Xu, Uu, Uu, Xu, Xu, Xu
Xu, Rd, Rd, Xu, Rd, Xu, Xu, Xu, Re, Re, Uu, Uu, Re, Uu, Rd, Rd, Re, Uu, Uu, Wwg, Wwg, Wwg, Wwrg, Wog, Wog, Wog, Wog, Wwg^Vm, Wog, Wwg^Vm, Wog, Wog, Wog, Xu, Xu, Xu, Xu, Xu, Xu, Sm, Xu, Xu, Xu, Uu, Xu, Xu, Xu, Uu, Uu, Xu, Xu, Xu
Xu, Uu, Uu, Uu, Uu, Xu, Qxu, Uu, Uu, Uu, Uu, Uu^Em, Uu, Rd, Uu^Vud, Re, Rd, Uu, Re, Uu, Wwg, Wwg, Wwg, Wog, Wog, Wog, Wog, Wog, Wog, Wog, Wog, Wog, Wog, Wog, Wog, Xu, Xu, Xu, Xu, Wog, Wwg^Vm, Wwg^Vm, Wog, Xu, Xu, Xu, Xu, Xu, Uu, Xu, Xu, Xu
Xu, Xu, Xu, Uu, Uu, Uu, Qlf, Uu, Uu, Rd, Uu, Xu, Xu, Xu, Xu, Uu, Cud, Cud, Cud, Uu^Em, Wwg, Wwg, Wwg, Wwg, Wwg, Wog, Wog, Wog, Wwg, Wwg, Cme, Chw, Cme, Wog, Wog, Wog, Wog, Xu, Wog, Wog, Wog, Wog, Wog, Wog, Xu, Xu, Xu, Uu, Uu, Xu, Xu, Xu
Xu, Xu, Rd, Rd, Re, Uu, Qxu, Uu^Vud, Uu, Rd, Re, Uu, Xu, Xu, Xu, Cud, 6 Cud^Kov, Cud, Rd, Uu^Em, Wwg, Wwg, Wwg, Wwg, Wwg, Wwg, Cme, Chw, Cme, 8 Kme, Wwg, Chw, Wwg, Wwg, Wwg, Wog, Wog, Wog, Wog, Wog, Wog, Wwg^Vm, Wog, Wwg^Vm, Wog, Xu, Xu, Rd, Rd, Xu, Xu, Xu
Xu, Rd, Uu, Re, Re, Re, Re, Xu, Uu, Rd, Re, Uu, Uu, Xu, Uh, Xu, Xu, Cud, Re, Re, Wwg, Wwg, Wwg, Wwg, Wwg, Wwg, Wwg, Chw, Wwg, Wog, Wog, Wwg, Wog, Wwrg, Wwg, Wwg, Wwg, Wwrg, Wwg, Wog, Xu, Wog, Wog, Wog, Wwf^Vm, Xu, Xu, Xu, Uu, Xu, Xu, Xu
Xu, Re, Uu, Uu, Re, Uu^Uf, Uu^Uf, Xu, Xu, Uu, Rd, Rd, Uu, Uh, Xu, Uu^Vud, Xu, Uu^Vu, Re, Wwg, Wwg, Wwg, Wwg, Wwg, Wwg, Wwg, Wwg, Wwg, Wwg, Wog, Wog, Wog, Wog, Wog, Wwg, Wwg, Wwg, Wwg, Wwf, Wwg^Bw/r, Wwg^Bw\r, Xu, Xu, Xu, Xu, Xu, Uu^Vud, Xu, Uu, Xu, Xu, Xu
Xu, Re, Re, Uu^Fetd, Rd, Rd, Uu^Uf, Xu, Xu, Uu, Rd, Uu^Fetd, Uu, Xu, Xu, Xu, Xu, Uu, Uu, Wwrg, Wwg, Wwg, Uu, Uu, Uu, Uu, Uu, Wwg, Wwg, Wwg, Wwg, Wog, Wwrg, Wog, Wwg, Wwg, Wwg, Wwf, Wwf, Wwg, Wwg, Wwf, Xu, Xu, Xu, Uu, Xu, Xu, Uu, Rd, Xu, Xu
Xu, Uu^Uf, Re, Uu, Uu, Rd, Uu^Uf, Xu, Xu, Uu, Uu, Re, Re, Uu, Uu^Vud, Uu, Uu, Xu, Xu, Uu, Uu, Uu, Xu, Uu, Xu, Xu, Xu, Uu, Uu, Wwg, Wwg, Wwg, Wwg, Wwg, Wwg, Wwg, Wwf, Wwf, Xu, Wwg^Bw\r, Wwg^Bw/r, Wwf, Wwf, Xu, Xu, Uu, Uu^Em, Xu, Xu, Uu, Uu, Xu
Xu, Uu^Uf, Rd, Re, Re, Rd, Re, Re, Xu, Xu, Qxu, Re, Uu, Uu, Uu, Rd, Rd, Uu, Uu^Uf, Xu, Xu, Xu, Xu, Xu, Uu, Uu, Xu, Xu, Uu, Uu, Uh, Wwg, Wwg, Wwg, Wwg, Wwf, Uu^Vud, Xu, Xu, Xu, Wwrg, Wwg, Wwg, Wwf, Xu, Xu, Uu, Xu, Rd, Rd, Xu, Xu
Xu, Xu, Rd, Re, Re, Uu, Re, Uu^Vud, Uu, Uu^Em, Uu, Xu, Xu, Xu, Xu, Uu, Xu, Rd, Re, Re^Es, Xu, Xu, Re, Uu, Re, Uu^Vud, Uu, Xu, Xu, Uu, Uu, Wwg, Uu, Wwg, Uu, Rd, Uu, Sm, Xu, Xu, Wog, Wwg, Wwg, Wwf, Wwg, Xu, Xu, Uu, Xu, Uu, Xu, Xu
Xu, Xu, Uu^Vu, Xu, Xu, Rd, Rd, Rd^Em, Rd^Uf, Rd^Uf, Uu, Cud, Cud, Uh, Uu^Vud, Xu, Xu, Rd, Re, Re, Xu, Xu, Re, Uu^Fetd, Re, Uu^Uf, Uu^Em, Uu, Xu, Uh, Uu, Uu, Re, Uu, Uu, Rd, Rd, Uu, Rd, Xu, Xu, Wog, Xu, Wwg, Wwg, Wwrg, Re, Xu, Xu, Uu, Uu, Xu
Xu, Xu, Xu, Xu, Xu, Xu, Xu, Uu, Uu, Rd, Cud, Cud, Cud, Uh, Uu, Uu^Uf, Uu^Vu, Xu, Uu, Re, Uu, Re, Rd, Re, Uh, Uu^Uf, Uu, Uu, Uu, Xu, Uh, Re, Re, Sm, Rd, Cud, Cud, Cud, Rd, Uu^Vud, Xu, Wog, Xu, Xu, Wwg^Bw/r, Wwg^Bw/r, Re^Es, Re, Xu, Uu, Uu, Xu
Xu, Xu, Xu, Xu, Xu, Xu, Xu, Uu, Qxu, Qxu, Xu, Cud, Uu, 4 Cud^Kov, Xu, Uu, Xu, Xu, Re, Uu, Uu, Rd^Es, Xu, Xu, Xu, Xu, Xu, Uu^Vu, Xu, Xu, Uu, Uu^Vud, Re, Cud, Cud, 7 Cud^Kov, Cud, Rd, Rd, Rd, Xu, Xu, Uu, Uu, Xu, Wwg, Wwg, Re, Rd, Xu, Uu, Xu
Xu, Xu, Xu, Xu, Xu, Xu, Qxu, Qxu, Xu, Xu, Xu, Xu, Xu, Xu, Xu, Xu, Re, Re, Uu, Uu, Uu, Uu^Uf, Xu, Uu^Vu, Uu, Uu^Em, Uu^Uf, Xu, Xu, Xu, Uu, Rd, Re, Re, Uu^Uf, Re, Uu^Uf, Rd, Uu^Uf, Rd, Xu, Uu, Xu, Xu, Xu, Wwg, Wwg, Wwg, Re, Rd, Rd, Xu
Xu, Xu, Xu, Xu, Xu, Qxu, Qxu, Xu, Xu, Xu, Uu^Vu, Xu, Uu, Xu, Rd, Rd, Rd, Uu, Xu, Xu, Uu^Uf, Uu^Em, Uh, Xu, Xu, Uu^Uf, Uu^Uf, Uh, Uh, Uh, Uh, Uu, Rd, Uu^Uf, Uu^Uf, Uu^Uf, Uu^Uf, Uu^Uf, Uu^Vu, Xu, Xu, Uu, Xu, Xu, Xu, Xu, Wwg^Bw/r, Wwg^Bw/r, Wwg, Re, Rd, Xu
Xu, Xu, Mm^Xm, Xu, Xu, Xu, Xu, Qxu, Uu^Uf, Uu^Uf, Rd, Rd, Rd, Rd, Rd, Rd, Rd, Uu^Vud, Xu, Xu, Uu^Uf, Uu^Uf, Uh, Uu^Uf, Xu, Uh, Uh, Uh, Uh^Fetd, Uh, Uu^Uf, Uu^Uf, Uu, Uu^Uf, Xu, Xu, Xu, Xu, Xu, Qxu, Uu, Uu, Uu, Xu, Uu, Uu, Xu, Wwg, Wwg^Bw/r, Re, Re, Xu
Mm^Xm, Mm^Xm, Aa^Es, Mm^Xm, Xu, Xu, Cud, Uu, Uu^Em, Uu^Uf, Re, Rd, Uu^Uf, Rd, Rd, Rd, Uu, Xu, Xu, Xu, Uu^Vu, Uu, Uu, Xu, Uh, Uh, Uh, Uh, Uh, Uh, Uu, Uu^Em, Xu, Xu, Re, Uu^Vud, Rd, Xu, Uh, Qlf, Uu^Em, Re, Re, Uu, Xu, Xu, Uu, Wwg^Bw/r, Wwg, Wwg, Wwg, Xu
Aa, Aa, Aa^Fpa, Mm^Xm, Mm^Xm, Cud, 1 Kud, Cud, Uu, Uu, Re, Re, Uu^Uf, Uu^Uf, Uh, Uu, Uu^Uf, Xu, Xu, Xu, Uu, Uu, Uu^Em, Xu, Uh, Uh, Uu^Uf, Uu^Uf, Uu^Vu, Uh, Xu, Xu, Uu, Re, Rd, Rd, Cud, Rd, Rd, Rd, Rd, Re, Re^Es, Re, Uu, Uu, Xu, Xu, Xu, Wog, Wog, Xu
Aa, Aa, Aa, Aa^Fpa, Aa, Cud, Cud, Cud, Re, Re, Re, Re, Uu, Uu^Em, Uu^Uf, Uh, Xu, Xu, Xu, Xu, Uu, Uu^Em, Uu^Uf, Uh, Uh, Uh, Uu^Uf, Uu^Uf, Uh, Uh, Xu, Uu, Uu^Vud, Re, Cud, Cud, 3 Cud^Kov, Cud, Uu^Uf, Uu^Uf, Uu^Uf, Rd, Xu, Re, Re, Uu^Em, Uu, Xu, Xu, Wog, Wog, Xu
Aa, Aa^Es, Aa, Aa, Aa^Fi|, Aa, Re, Re, Re, Uu^Ufi, Cud, Cud, Cud, Cud, Xu, Qxu, Qxu, Qxu, Qxu, Uu, Uu, Uu^Em, Xu, Uu, Xu, Uu, Xu, Uh, Xu, Xu, Qxu, Uu, Re, Re, Cud, Cud, Cud, Cud, Uu^Uf, Uu^Em, Uu, Xu, Xu, Uu^Em, Uu^Uf, Uu^Uf, Uu^Vu, Xu, Wwf^Vm, Wog, Wog, Wog
Aa, Aa, Re, Re, Re, Re, Re, Re, Aa, Cud, Cud, 2 Kud, Xu, Xu, Xu, Xu, Xu, Qxu, Qxu, Qlf, Qxu, Xu, Qxu, Xu, Xu, Uu^Vud, Xu, Xu, Qxu, Qxu, Xu, Re, Re, Re, Uu^Uf, Cud, Uu^Uf, Uh, Uu, Uu, Uu^Vu, Xu, Uu^Vud, Uu, Uu^Em, Uu^Uf, Xu, Xu, Uu, Wog, Wwg^Vm, Wog
Aa^Es, Aa, Re, Re, Re, Re, Aa^Fi|, Aa, Aa^Fpa, Aa^Fpa, Mm^Xm, Xu, Mm^Xm, Xu, Xu, Xu, Xu, Xu, Xu, Xu, Xu, Qxu, Xu, Qxu, Qxu, Xu, Qxu, Qxu, Xu, Xu, Xu, Xu, Uu, Uu, Uh, Uu^Uf, Uh, Uh, Uu^Fetd, Uu, Uu^Vu, Xu, Uu, Uu, Uu, Xu, Xu, Uu, Uu^Em, Uu, Uu^Em, Wog
Re, Re, Re, Re, Aa^Es, Aa, Aa^Es, Aa, Aa, Aa^Fpa, Aa^Fpa, Mm^Xm, Mm^Xm, Mm^Xm, Xu, Xu, Xu, Xu, Xu, Xu, Xu, Xu, Xu, Xu, Xu, Qxu, Xu, Xu, Xu, Xu, Xu, Xu, Uu, Uu, Uu, Uh, Uh, Uh, Uu, Uu, Xu, Xu, Uu^Em, Uu, Uu, Xu, Xu, Uu^Em, Uu^Emf, Uu^Em, Uu, Wog
Re, Re, Re, Aa, Aa, Aa, Aa, Aa, Aa, Aa, Aa, Aa^Es, Aa, Mm^Xm, Mm^Xm, Xu, Xu, Xu, Xu, Xu, Xu, Xu, Xu, Xu, Xu, Xu, Xu, Xu, Xu, Xu, Xu, Xu, Xu, Xu, Xu, Xu, Xu, Xu, Xu, Xu, Xu, Xu, Xu, Xu, Xu, Xu, Xu, Uu^Emf, Uu^Emf, Uu^Em, Uu, Uu
