Xu, Xu, Xu, Wog, Wog, Wog, Wog, Wog, Wog, Wog, Wwg, Wwg, Xu, Xu, Xu, Xu, Xu, Xu, Xu, Xu, Xu, Xu, Xu, Xu, Xu, Xu, Xu, Xu, Xu, Xu, Xu, Xu, Xu, Xu, Xu, Xu, Xu, Xu, Xu, Xu, Xu, Xu, Xu, Xu, Xu, Xu, Xu, Xu, Xu, Xu, Re, Re
Xu, Xu, Uu^Emf, Uu, Uu, Wwg^Vm, Wog, Wog, Wog, Wog, Wwrg, Wwg, Xu, Xu, Xu, Xu, Uu^Tf, Xu, Re, Uu^Tf, Xu, Xu, Xu, Xu, Xu, Xu, Uu^Vud, Xu, Xu, Xu, Xu, Xu, Qxu, Xu, Qxu, Xu, Xu, Xu, Xu, Xu, Xu, Xu, Xu, Xu, Xu, Xu, Xu, Xu, Xu, Re, Re, Xu
Xu, Uu^Em, Uu^Emf, Uu^Em, Uu, Uu, Wog, Wog, Wog, Wog, Wwg, Wwg, Xu, Xu, Xu, Xu, Re, Uu, Xu, Uu^Em, Uu, Xu, Xu, Xu, Xu, Xu, Re, Re, Uu^Tf, Uu^Vud, Re, Qxu, Xu, Qxu, Xu, Qxu, Qxu, Xu, Xu, Xu, Xu, Xu, Xu, Xu, Xu, Xu, Xu, Xu, Re, Re, Xu, Xu
Xu, Xu, Uu^Emf, Uu^Emf, Uu, Uu^Em, Xu, Wwg^Vm, Wog, Wog, Wwg, Wwg, Xu, Xu, Uu^Em, Re, Xu, Xu, Xu, Re, Re, Re, Re, Re, Uu^Em, Uu^Vu, Rd, Uu^Tf, Uu^Tf, Uu^Tf, Xu, Xu, Xu, Xu, Xu, Xu, Xu, Qxu, Qxu, Xu, Xu, Xu, Xu, Xu, Re, Re, Re, Re, Re, Xu, Xu, Xu
Xu, Xu, Uu, Uu^Em, Uu, Uu^Emf, Xu, Xu, Wog, Wog, Wwg, Xu, Xu, Uu^Tf, Uu, Xu, Xu, Xu, Xu, Xu, Xu, Xu, Uu^Vu, Re, Uu^Tf, Re, Rd, Uu^Tf, Xu, Qlf, Xu, Xu, Xu, Re, Xu, Xu, Re, Xu, Xu, Qxu, Uu, Re, Uu^Vu, Rd, Rd, Re, Re, Re, Xu, Xu, Xu, Xu
Xu, Xu, Xu, Uu, Xu, Xu, Xu, Xu, Wog, Wog, Wwg, Xu, Xu, Xu, Re, Re, Re, Re, Uu, Uu^Tf, Uu^Tf, Xu, Uu, Uu^Tf, Xu, Re, Uu^Vud, Rd, Xu, Qxu, Uu, Uu^Fetd, Uu^Em, Re, Re, Re, Xu, Re, Uu, Uu, Re, Re, Cud, Rd, Rd, Rd, Xu, Xu, Xu, Xu, Xu, Xu
Xu, Xu, Xu, Xu, Xu, Xu, Xu, Xu, Xu, Wwg, Wwg, Xu, Xu, Xu, Xu, Xu, Xu, Xu, Xu, Rd, Xu, Xu, Uu, Xu, Xu, Xu, Xu, Xu, Xu, Xu, Re, Re, Re, Re, Xu, Xu, Uu, Uu^Em, Uu^Tf, Re, Cud, Cud, Cud, Cud, Cud, Uu^Em, Uu^Tf, Xu, Xu, Xu, Xu, Xu
Xu, Xu, Xu, Xu, Xu, Xu, Xu, Xu, Xu, Wwg, Wwg, Xu, Re, Xu, Uu^Tf, Xu, Rd, Rd, Rd, Rd, Xu, Xu, Qxu, Qlf, Qxu, Xu, Xu, Uu^Vu, Rd, Rd, Xu, Xu, Xu, Xu, Xu, Xu, Uu^Em, Uu^Tf, Uu^Vu, Re, Cud, Cud, Cud, 5 Cud^Kov, Cud, Re, Uu^Tf, Xu, Xu, Xu, Xu, Xu
Xu, Xu, Xu, Xu, Xu, Xu, Xu, Xu, Rd, Xu, Wwg^Bw/r, Rd, Xu, Uu, Xu, Rd, Xu, Xu, Xu, Xu, Xu, Xu, Uu, Xu, Xu, Qxu, Uu, Re, Rd, Xu, Xu, Xu, Xu, Uu^Vu, Xu, Xu, Re, Uu^Tf, Uu^Em, Re, Re, Cud, Cud, Cud, Re, Uu^Em, Uu^Tf, Xu, Uh, Uh, Uu^Vud, Xu
Xu, Xu, Xu, Xu, Xu, Xu, Xu, Uu, Xu, Rd, Wwg, Wwg, Wwg, Xu, Xu, Uu^Em, Re, Xu, Xu, Xu, Rd, Rd, Xu, Xu, Xu, Re, Uu, Xu, Re, Xu, Xu, Xu, Xu, Re, Re, Xu, Xu, Re, Uu, Uu, Uu, Cud, Rd, Cud, Uu, Uu^Em, Xu, Xu, Uh, Xu, Xu, Xu
Xu, Xu, Xu, Xu, Re, Xu, Re, Re, Xu, Xu, Xu, Wwg, Wwg, Xu, Xu, Uu^Tf, Re, Xu, Re, Uu, Xu, Rd, Xu, Xu, Rd, Re, Uu^Vud, Xu, Re, Xu, Uu, Xu, Xu, Xu, Rd, Xu, Xu, Xu, Xu, Uu^Vud, Re, Rd, Re, Re, Uu^Vu, Re^Es, Uu, Xu, Xu, Uh, Xu, Xu
Xu, Xu, Xu, Re, Xu, Re, Xu, Re, Uu, Xu, Xu, Wwg, Wwg, Wwg, Xu, Xu, Xu, Re, Xu, Xu, Uu, Rd, Xu, Re, Rd, Xu, Xu, Xu, Uu, Uu, Xu, Uu, Xu, Xu, Xu, Re^Es, Xu, Xu, Qxu, Qxu, Qxu, Re, Xu, Re, Xu, Xu, Uu, Xu, Xu, Uh, Uh, Xu
Xu, Xu, Qlf, Qlf, Qlf^Bs/, Re, Re^Em, Xu, Re, Xu, Xu, Xu, Wwg, Wwg, Wwg, Xu, Xu, Xu, Xu, Uu^Tf, Uu^Tf, Rd, Re, Uu, Xu, Xu, Xu, Uu, Rd, Xu, Xu, Re, Xu, Xu, Uu, Uu, Xu, Qxu, Xu, Xu, Xu, Qxu, Xu, Uu, Uu, Xu, Uu, Uu, Xu, Uh, Xu, Xu
Xu, Xu, Qlf^Bs/, Qlf^Bs/, Qlf, Qlf, Qlf, Re, Xu, Re, Xu, Xu, Xu, Wwg, Wwg, Wwg, Wwg, Xu, Xu, Xu, Xu, Xu, Xu, Uu, Xu, Xu, Re, Rd, Xu, Xu, Rd, Re, Re^Es, Uu, Xu, Re, Xu, Qxu, Xu, Xu, Xu, Qxu, Xu, Xu, Xu, Uu, Xu, Rd, Uu, Uu, Xu, Xu
Xu, Re, Qlf, Qlf, Qlf, Qlf, Qlf^Bs/, Re, Xu, Re, Uu, Xu, Xu, Xu, Xu, Wwg, Wwg, Wwg, Wwg, Xu, Xu, Xu, Rd, Uu, Xu, Uu^Vud, Re, Xu, Xu, Uu, Uu, Xu, Xu, Xu, Xu, Xu, Uu, Qxu, Qxu, Xu, Qxu, Qxu, Xu, Uu^Vu, Uu, Xu, Xu, Uu, Uu, Xu, Xu, Xu
Xu, Re, Xu, Qlf, Qlf^Bs/, Qlf^Bs/, Qlf, Xu, Xu, Xu, Xu, Uu, Xu, Xu, Xu, Xu, Uu, Wwg, Wwg, Xu, Xu, Xu, Re, Xu, Xu, Xu, Xu, Xu, Xu, Xu, Xu, Xu, Xu, Xu, Uu, Uu, Uu, Uu, Uu^Fetd, Qxu, Qxu, Xu, Xu, Uu, Uu^Em, Xu, Xu, Xu, Uu, Xu, Xu, Xu
Xu, Re, Xu, Re, Re, Qlf, Xu, Xu, Uu^Vud, Xu, Uu^Em, Uu, Uu^Em, Xu, Xu, Xu, Uu, Uu^Fetd, Wwg, Wwg, Wwg^Bw/r, Re, Xu, Xu, Wog, Xu, Wog, Wog, Wwg^Vm, Xu, Wog, Wog, Wog, Sm, Xu, Uu, Xu, Uu, Uu, Uu, Xu, Xu, Uu, Xu, Xu, Uu^Tf, Xu, Uu, Rd, Xu, Xu, Xu
Xu, Re, Xu, Xu, Re, Xu, Xu, Xu, Uu, Uu, Re, Uu, Uu, Xu, Uu, Uu^Vu, Uu, Re, Wwg^Bw/r, Wwg^Bw/r, Wwg, Uu^Vud, Xu, Xu, Wog, Wwg^Vm, Wog, Wog, Wog, Wog, Wog, Wwg^Vm, Xu, Xu, Xu, Xu, Xu, Xu, Xu, Uu, Uu, Uu^Tf, Xu, Uu, Uu^Em, Uu^Tf, Xu, Uu, Uu, Xu, Xu, Xu
Xu, Rd, Rd, Xu, Rd, Xu, Xu, Xu, Re, Re, Uu, Uu, Re, Uu, Rd, Rd, Re, Uu, Uu, Wwg, Wwg, Wwg, Wwrg, Wog, Wog, Wog, Wog, Wwg^Vm, Wog, Wwg^Vm, Wog, Wog, Wog, Xu, Xu, Xu, Xu, Xu, Xu, Sm, Xu, Xu, Xu, Uu, Xu, Xu, Xu, Uu, Uu, Xu, Xu, Xu
Xu, Uu, Uu, Uu, Uu, Xu, Qxu, Uu, Uu, Uu, Uu, Uu^Em, Uu, Rd, Uu^Vud, Re, Rd, Uu, Re, Uu, Wwg, Wwg, Wwg, Wog, Wog, Wog, Wog, Wog, Wog, Wog, Wog, Wog, Wog, Wog, Wog, Xu, Xu, Xu, Xu, Wog, Wwg^Vm, Wwg^Vm, Wog, Xu, Xu, Xu, Xu, Xu, Uu, Xu, Xu, Xu
Xu, Xu, Xu, Uu, Uu, Uu, Qlf, Uu, Uu, Rd, Uu, Xu, Xu, Xu, Xu, Uu, Cud, Cud, Cud, Uu^Em, Wwg, Wwg, Wwg, Wwg, Wwg, Wog, Wog, Wog, Wwg, Wwg, Cme, Chw, Cme, Wog, Wog, Wog, Wog, Xu, Wog, Wog, Wog, Wog, Wog, Wog, Xu, Xu, Xu, Uu, Uu, Xu, Xu, Xu
Xu, Xu, Rd, Rd, Re, Uu, Qxu, Uu^Vud, Uu, Rd, Re, Uu, Xu, Xu, Xu, Cud, 6 Cud^Kov, Cud, Rd, Uu^Em, Wwg, Wwg, Wwg, Wwg, Wwg, Wwg, Cme, Chw, Cme, 8 Kme, Wwg, Chw, Wwg, Wwg, Wwg, Wog, Wog, Wog, Wog, Wog, Wog, Wwg^Vm, Wog, Wwg^Vm, Wog, Xu, Xu, Rd, Rd, Xu, Xu, Xu
Xu, Rd, Uu, Re, Re, Re, Re, Xu, Uu, Rd, Re, Uu, Uu, Xu, Uh, Xu, Xu, Cud, Re, Re, Wwg, Wwg, Wwg, Wwg, Wwg, Wwg, Wwg, Chw, Wwg, Wog, Wog, Wwg, Wog, Wwrg, Wwg, Wwg, Wwg, Wwrg, Wwg, Wog, Xu, Wog, Wog, Wog, Wwf^Vm, Xu, Xu, Xu, Uu, Xu, Xu, Xu
Xu, Re, Uu, Uu, Re, Uu^Tf, Uu^Tf, Xu, Xu, Uu, Rd, Rd, Uu, Uh, Xu, Uu^Vud, Xu, Uu^Vu, Re, Wwg, Wwg, Wwg, Wwg, Wwg, Wwg, Wwg, Wwg, Wwg, Wwg, Wog, Wog, Wog, Wog, Wog, Wwg, Wwg, Wwg, Wwg, Wwf, Wwg^Bw/r, Wwg^Bw\r, Xu, Xu, Xu, Xu, Xu, Uu^Vud, Xu, Uu, Xu, Xu, Xu
Xu, Re, Re, Uu^Fetd, Rd, Rd, Uu^Tf, Xu, Xu, Uu, Rd, Uu^Fetd, Uu, Xu, Xu, Xu, Xu, Uu, Uu, Wwrg, Wwg, Wwg, Uu, Uu, Uu, Uu, Uu, Wwg, Wwg, Wwg, Wwg, Wog, Wwrg, Wog, Wwg, Wwg, Wwg, Wwf, Wwf, Wwg, Wwg, Wwf, Xu, Xu, Xu, Uu, Xu, Xu, Uu, Rd, Xu, Xu
Xu, Uu^Tf, Re, Uu, Uu, Rd, Uu^Tf, Xu, Xu, Uu, Uu, Re, Re, Uu, Uu^Vud, Uu, Uu, Xu, Xu, Uu, Uu, Uu, Xu, Uu, Xu, Xu, Xu, Uu, Uu, Wwg, Wwg, Wwg, Wwg, Wwg, Wwg, Wwg, Wwf, Wwf, Xu, Wwg^Bw\r, Wwg^Bw/r, Wwf, Wwf, Xu, Xu, Uu, Uu^Em, Xu, Xu, Uu, Uu, Xu
Xu, Uu^Tf, Rd, Re, Re, Rd, Re, Re, Xu, Xu, Qxu, Re, Uu, Uu, Uu, Rd, Rd, Uu, Re^Tf, Xu, Xu, Xu, Xu, Xu, Uu, Uu, Xu, Xu, Uu, Uu, Uh, Wwg, Wwg, Wwg, Wwg, Wwf, Uu^Vud, Xu, Xu, Xu, Wwrg, Wwg, Wwg, Wwf, Xu, Xu, Uu, Xu, Rd, Rd, Xu, Xu
Xu, Xu, Rd, Re, Re, Uu, Re, Uu^Vud, Uu, Uu^Em, Uu, Xu, Xu, Xu, Xu, Uu, Xu, Rd, Re, Re^Es, Xu, Xu, Re, Uu, Re, Uu^Vud, Uu, Xu, Xu, Uu, Uu, Wwg, Uu, Wwg, Uu, Rd, Uu, Sm, Xu, Xu, Wog, Wwg, Wwg, Wwf, Wwg, Xu, Xu, Uu, Xu, Uu, Xu, Xu
Xu, Xu, Uu^Vu, Xu, Xu, Rd, Rd, Rd^Em, Uu^Tf, Uu^Tf, Uu, Cud, Cud, Uh, Uu^Vud, Xu, Xu, Rd, Re, Re, Xu, Xu, Re, Uu^Fetd, Re, Re^Tf, Uu^Em, Uu, Xu, Uh, Uu, Uu, Re, Uu, Uu, Rd, Rd, Uu, Rd, Xu, Xu, Wog, Xu, Wwg, Wwg, Wwrg, Re, Xu, Xu, Uu, Uu, Xu
Xu, Xu, Xu, Xu, Xu, Xu, Xu, Uu, Uu, Rd, Cud, Cud, Cud, Uh, Uu, Uu^Tf, Uu^Vu, Xu, Uu, Re, Uu, Re, Rd, Re, Uh, Re^Tf, Uu, Uu, Uu, Xu, Uh, Re, Re, Sm, Rd, Cud, Cud, Cud, Rd, Uu^Vud, Xu, Wog, Xu, Xu, Wwg^Bw/r, Wwg^Bw/r, Re^Es, Re, Xu, Uu, Uu, Xu
Xu, Xu, Xu, Xu, Xu, Xu, Xu, Uu, Qxu, Qxu, Xu, Cud, Uu, 4 Cud^Kov, Xu, Uu, Xu, Xu, Re, Uu, Uu, Rd^Es, Xu, Xu, Xu, Xu, Xu, Uu^Vu, Xu, Xu, Uu, Uu^Vud, Re, Cud, Cud, 7 Cud^Kov, Cud, Rd, Rd, Rd, Xu, Xu, Uu, Uu, Xu, Wwg, Wwg, Re, Rd, Xu, Uu, Xu
Xu, Xu, Xu, Xu, Xu, Xu, Qxu, Qxu, Xu, Xu, Xu, Xu, Xu, Xu, Xu, Xu, Re, Re, Uu, Uu, Uu, Uu^Tf, Xu, Uu^Vu, Uu, Uu^Em, Uu^Tf, Xu, Xu, Xu, Uu, Rd, Re, Re, Uu^Tf, Re, Uu^Tf, Rd, Uu^Tf, Rd, Xu, Uu, Xu, Xu, Xu, Wwg, Wwg, Wwg, Re, Rd, Rd, Xu
Xu, Xu, Xu, Xu, Xu, Qxu, Qxu, Xu, Xu, Xu, Uu^Vu, Xu, Uu, Xu, Rd, Rd, Rd, Uu, Xu, Xu, Uu^Tf, Uu^Em, Uh, Xu, Xu, Uu^Tf, Uu^Tf, Uh, Uh, Uh, Uh, Uu, Rd, Uu^Tf, Uu^Tf, Uu^Tf, Uu^Tf, Uu^Tf, Uu^Vu, Xu, Xu, Uu, Xu, Xu, Xu, Xu, Wwg^Bw/r, Wwg^Bw/r, Wwg, Re, Rd, Xu
Xu, Xu, Mm^Xm, Xu, Xu, Xu, Xu, Qxu, Uu^Tf, Uu^Tf, Rd, Rd, Rd, Rd, Rd, Rd, Rd, Uu^Vud, Xu, Xu, Uu^Tf, Uu^Tf, Uh, Uu^Tf, Xu, Uh, Uh, Uh, Uh^Fetd, Uh, Uu^Tf, Uu^Tf, Uu, Uu^Tf, Xu, Xu, Xu, Xu, Xu, Qxu, Uu, Uu, Uu, Xu, Uu, Uu, Xu, Wwg, Wwg^Bw/r, Re, Re, Xu
Mm^Xm, Mm^Xm, Aa^Es, Mm^Xm, Xu, Xu, Cte, Uu, Uu^Em, Uu^Tf, Re, Rd, Re^Tf, Rd, Rd, Rd, Uu, Xu, Xu, Xu, Uu^Vu, Uu, Uu, Xu, Uh, Uh, Uh, Uh, Uh, Uh, Uu, Uu^Em, Xu, Xu, Re, Uu^Vud, Rd, Xu, Uh, Qlf, Uu^Em, Re, Re, Uu, Xu, Xu, Uu, Wwg^Bw/r, Wwg, Wwg, Wwg, Xu
Aa, Aa, Aa^Fpa, Mm^Xm, Mm^Xm, Cte, Kte, Cte, Uu, Uu, Re, Re, Uu^Tf, Re^Tf, Uh, Uu, Uu^Tf, Xu, Xu, Xu, Uu, Uu, Uu^Em, Xu, Uh, Uh, Uu^Tf, Uu^Tf, Uu^Vu, Uh, Xu, Xu, Uu, Re, Rd, Rd, Cud, Rd, Rd, Rd, Rd, Re, Re^Es, Re, Uu, Uu, Xu, Xu, Xu, Wog, Wog, Xu
Aa, Aa, Aa, Aa^Fpa, Aa, Cte, Cte, Cte, Re, Re, Re, Re, Uu, Uu^Em, Uu^Tf, Uh, Xu, Xu, Xu, Xu, Uu, Uu^Em, Uu^Tf, Uh, Uh, Uh, Uu^Tf, Uu^Tf, Uh, Uh, Xu, Uu, Uu^Vud, Re, Cud, Cud, 3 Cud^Kov, Cud, Uu^Tf, Uu^Tf, Uu^Tf, Rd, Xu, Re, Re, Uu^Em, Uu, Xu, Xu, Wog, Wog, Xu
Aa, Aa^Es, Aa, Aa, Aa^Fi|, Aa, Re, Re, Re, Re^Tf, Cte, Cte, Cte, Cte, Xu, Qxu, Qxu, Qxu, Qxu, Uu, Uu, Uu^Em, Xu, Uu, Xu, Uu, Xu, Uh, Xu, Xu, Qxu, Uu, Re, Re, Cud, Cud, Cud, Cud, Uu^Tf, Uu^Em, Uu, Xu, Xu, Uu^Em, Uu^Tf, Uu^Tf, Uu^Vu, Xu, Wwf^Vm, Wog, Wog, Wog
Aa, Aa, Re, Re, 2 Re, Re, 1 Re, Re, Aa, Cte, Cte, Kte, Xu, Xu, Xu, Xu, Xu, Qxu, Qxu, Qlf, Qxu, Xu, Qxu, Xu, Xu, Uu^Vud, Xu, Xu, Qxu, Qxu, Xu, Re, Re, Re, Uu^Tf, Cud, Uu^Tf, Uh, Uu, Uu, Uu^Vu, Xu, Uu^Vud, Uu, Uu^Em, Uu^Tf, Xu, Xu, Uu, Wog, Wwg^Vm, Wog
Aa^Es, Aa, Re, Re, Re, Re, Aa^Fi|, Aa, Aa^Fpa, Aa^Fpa, Mm^Xm, Xu, Mm^Xm, Xu, Xu, Xu, Xu, Xu, Xu, Xu, Xu, Qxu, Xu, Qxu, Qxu, Xu, Qxu, Qxu, Xu, Xu, Xu, Xu, Uu, Uu, Uh, Uu^Tf, Uh, Uh, Uu^Fetd, Uu, Uu^Vu, Xu, Uu, Uu, Uu, Xu, Xu, Uu, Uu^Em, Uu, Uu^Em, Wog
Re, Re, Re, Re, Aa^Es, Aa, Aa^Es, Aa, Aa, Aa^Fpa, Aa^Fpa, Mm^Xm, Mm^Xm, Mm^Xm, Xu, Xu, Xu, Xu, Xu, Xu, Xu, Xu, Xu, Xu, Xu, Qxu, Xu, Xu, Xu, Xu, Xu, Xu, Uu, Uu, Uu, Uh, Uh, Uh, Uu, Uu, Xu, Xu, Uu^Em, Uu, Uu, Xu, Xu, Uu^Em, Uu^Emf, Uu^Em, Uu, Wog
Re, Re, Re, Aa, Aa, Aa, Aa, Aa, Aa, Aa, Aa, Aa^Es, Aa, Mm^Xm, Mm^Xm, Xu, Xu, Xu, Xu, Xu, Xu, Xu, Xu, Xu, Xu, Xu, Xu, Xu, Xu, Xu, Xu, Xu, Xu, Xu, Xu, Xu, Xu, Xu, Xu, Xu, Xu, Xu, Xu, Xu, Xu, Xu, Xu, Uu^Emf, Uu^Emf, Uu^Em, Uu, Uu
