border_size=1
usage=map

Xu          , Xu          , Xu          , Xu          , Xu          , Xu          , Xu          , Xu          , Xu          , Xu          , Xu          , Xu          , Xu          , Xu          , Xu          , Xu          , Xu          , Xu          , Xu          , Xu          , Xu          , Xu          , Xu          , Xu          , Xu          , Xu          , Xu          , Xu          , Xu          , Xu          , Xu          , Xu          , Xu          , Xu          , Xu          , Xu          , Xu          , Xu          , Xu          , Xu          , Xu          , Dd          , Dd          , Dd          
Xu          , Xu          , Xu          , Xu          , Xu          , Xu          , Xu          , Xu          , Xu          , Xu          , Xu          , Xu          , Xu          , Xu          , Xu          , Xu          , Xu          , Xu          , Xu          , Xu          , Xuc         , Xu          , Xuc         , Xu          , Xu          , Xu          , Xu          , Xu          , Xu          , Xu          , Xu          , Xu          , Xu          , Xu          , Xu          , Xu          , Xu          , Xu          , Xu          , Xu          , Xu          , Xu          , Dd          , Dd          
Xu          , Xu          , Xu          , Xu          , Xu          , Xu          , Xu          , Xu          , Xu          , Xu          , Xu          , Xu          , Xu          , Xu          , Xu          , Xu          , Xu          , Xu          , Xu          , Xu          , Rd          , Rd          , Rd          , Xu          , Xu          , Xu          , Xu          , Xu          , Xu          , Xu          , Xu          , Xu          , Xu          , Xu          , Xu          , Xu          , Xu          , Xu          , Xu          , Xu          , Xu          , Xu          , Dd          , Dd          
Xu          , Xu          , Xu          , Xu          , Xu          , Xu          , Xu          , Xu          , Xu          , Xu          , Xu          , Xu          , Xu          , Xu          , Xu          , Xu          , Xu          , Xu          , Rd          , Rd          , Xuc         , Xuc         , Xuc         , Rd          , Rd          , Xu          , Xu          , Xu          , Xu          , Xu          , Xu          , Xu          , Xu          , Xu          , Xu          , Xu          , Xu          , Xu          , Xu          , Xu          , Xu          , Xu          , Dd          , Dd          
Xu          , Xu          , Xu          , Xu          , Xu          , Xu          , Xu          , Xu          , Xu          , Xu          , Xu          , Xu          , Xu          , Xu          , Xu          , Xu          , Rd          , Rd          , Xuc         , Xuc         , Rd          , Rd          , Rd          , Xuc         , Xuc         , Rd          , Rd          , Xu          , Xu          , Xu          , Xu          , Xu          , Xu          , Xu          , Xu          , Xu          , Xu          , Xu          , Xu          , Xu          , Xu          , Xu          , Dd          , Dd          
Xu          , Xu          , Xu          , Xu          , Xu          , Xu          , Xu          , Xu          , Xu          , Xu          , Xu          , Xu          , Xu          , Xu          , Rd          , Rd          , Xuc         , Xuc         , Rd          , Rd          , Xuc         , Xuc         , Xuc         , Rd          , Rd          , Xuc         , Xuc         , Rd          , Rd          , Xu          , Xu          , Xu          , Xu          , Xu          , Xu          , Xu          , Xu          , Xu          , Xu          , Xu          , Xu          , Xu          , Dd          , Dd          
Xu          , Xu          , Xu          , Xu          , Xu          , Xu          , Xu          , Xu          , Xu          , Xu          , Xu          , Xu          , Rd          , Rd          , Xuc         , Xuc         , Rd          , Rd          , Xuc         , Xuc         , Rd          , Rd          , Rd          , Xuc         , Xuc         , Rd          , Rd          , Xuc         , Xuc         , Rd          , Rd          , Xu          , Xu          , Xu          , Xu          , Xu          , Xu          , Xu          , Xu          , Xu          , Xu          , Xu          , Dd          , Dd          
Xu          , Xu          , Xu          , Xu          , Xu          , Xu          , Xu          , Xu          , Xu          , Xu          , Rd          , Rd          , Xuc         , Xuc         , Rd          , Rd          , Xuc         , Xuc         , Rd          , Rd          , Xuc         , Xuc         , Xuc         , Rd          , Rd          , Xuc         , Xuc         , Rd          , Rd          , Xuc         , Xuc         , Rd          , Rd          , Xu          , Xu          , Xu          , Xu          , Xu          , Xu          , Xu          , Xu          , Xu          , Dd          , Dd          
Xu          , Xu          , Xu          , Xu          , Xu          , Xu          , Xu          , Xu          , Rd          , Rd          , Xuc         , Xuc         , Rd          , Rd          , Xuc         , Xuc         , Rd          , Rd          , Xuc         , Xuc         , Rd          , Rd          , Rd          , Xuc         , Xuc         , Rd          , Rd          , Xuc         , Xuc         , Rd          , Rd          , Xuc         , Xuc         , Rd          , Rd          , Xu          , Xu          , Xu          , Xu          , Xu          , Dd          , Dd          , Dd          , Dd          
Xu          , Xu          , Xu          , Xu          , Xu          , Xuc         , Rd          , Rd          , Xuc         , Xuc         , Rd          , Rd          , Xuc         , Xuc         , Rd          , Rd          , Xuc         , Xuc         , Rd          , Rd          , Xuc         , Xuc         , Xuc         , Rd          , Rd          , Xuc         , Xuc         , Rd          , Rd          , Xuc         , Xuc         , Rd          , Rd          , Xuc         , Xuc         , Rd          , Rd          , Xu          , Xu          , Dd          , Dd          , 3 Ke        , Dd          , Dd          
Xu          , Xu          , Xu          , Xu          , Xuc         , Rd          , Xuc         , Xuc         , Rd          , Rd          , Xuc         , Xuc         , Rd          , Rd          , Xuc         , Xuc         , Rd          , Rd          , Xuc         , Xuc         , Rd          , Rd          , Rd          , Xuc         , Xuc         , Rd          , Rd          , Xuc         , Xuc         , Rd          , Rd          , Xuc         , Xuc         , Rd          , Rd          , Xuc         , Xuc         , Rd          , Xu          , Dd          , Ce          , Ce          , Ce          , Dd          
Xu          , Xu          , Xu          , Xu          , Xu          , Rd          , Xuc         , Rd          , Xuc         , Xuc         , Rd          , Rd          , Xuc         , Xuc         , Rd          , Rd          , Xuc         , Xuc         , Rd          , Rd          , Xuc         , Xuc         , Xuc         , Rd          , Rd          , Xuc         , Xuc         , Rd          , Rd          , Xuc         , Xuc         , Rd          , Rd          , Xuc         , Xuc         , Rd          , Xuc         , Rd          , Xu          , Dd          , Dd          , Re          , Dd          , Dd          
Xu          , Xu          , Xu          , Xu          , Xu          , Rd          , Xuc         , Rd          , Xuc         , Rd          , Xuc         , Xuc         , Rd          , Rd          , Xuc         , Xuc         , Rd          , Rd          , Xuc         , Xuc         , Rd          , Rd          , Rd          , Xuc         , Xuc         , Rd          , Rd          , Xuc         , Xuc         , Rd          , Rd          , Xuc         , Xuc         , Rd          , Xuc         , Rd          , Xuc         , Rd          , Xu          , Dd          , Dd          , Re          , Dd          , Dd          
Xu          , Xu          , Xu          , Xu          , Xu          , Rd          , Xuc         , Rd          , Xuc         , Rd          , Xuc         , Rd          , Xuc         , Xuc         , Rd          , Rd          , Xuc         , Xuc         , Rd          , Rd          , Xuc         , Xuc         , Xuc         , Rd          , Rd          , Xuc         , Xuc         , Rd          , Rd          , Xuc         , Xuc         , Rd          , Xuc         , Rd          , Xuc         , Rd          , Xuc         , Rd          , Xu          , Dd          , Re          , Re          , Dd          , Dd          
Xu          , Xu          , Xu          , Xu          , Xu          , Rd          , Xuc         , Rd          , Xuc         , Rd          , Xuc         , Rd          , Xuc         , Rd          , Xuc         , Xuc         , Rd          , Rd          , Xuc         , Xuc         , Rd          , Rd          , Rd          , Xuc         , Xuc         , Rd          , Rd          , Xuc         , Xuc         , Rd          , Xuc         , Rd          , Xuc         , Rd          , Xuc         , Rd          , Xuc         , Rd          , Xu          , Dd          , Re          , Dd          , Dd          , Dd          
Xu          , Xu          , Xu          , Xu          , Xu          , Rd          , Xuc         , Rd          , Xuc         , Rd          , Xuc         , Rd          , Xuc         , Rd          , Xuc         , Rd          , Xuc         , Xuc         , Rd          , Rd          , Xu          , Xu          , Xu          , Rd          , Rd          , Xuc         , Xuc         , Rd          , Xuc         , Rd          , Xuc         , Rd          , Xuc         , Rd          , Xuc         , Rd          , Xuc         , Rd          , Xu          , Re          , Dd          , Dd          , Dd          , Dd          
Xu          , Xu          , Xu          , Xu          , Xu          , Rd          , Xuc         , Rd          , Xuc         , Rd          , Xuc         , Rd          , Xuc         , Rd          , Xuc         , Rd          , Xuc         , Rd          , Xu          , Xu          , Rd          , Rd          , Rd          , Xu          , Xuc         , Rd          , Xuc         , Rd          , Xuc         , Rd          , Xuc         , Rd          , Xuc         , Rd          , Xuc         , Rd          , Xuc         , Rd          , Xu          , Re          , Re          , Dd          , Dd          , Dd          
Xu          , Xu          , Xu          , Xu          , Xu          , Rd          , Xuc         , Rd          , Xuc         , Rd          , Xuc         , Rd          , Xuc         , Rd          , Xuc         , Rd          , Xuc         , Rd          , Xu          , Rd          , Cud         , Cud         , Cud         , Rd          , Xu          , Rd          , Xuc         , Rd          , Xuc         , Rd          , Xuc         , Rd          , Xuc         , Rd          , Xuc         , Rd          , Xuc         , Rd          , Xu          , Dd          , Dd          , Re          , Dd          , Dd          
Xu          , Xu          , Xu          , Xu          , Xu          , Rd          , Xu          , Rd          , Xu          , Rd          , Xu          , Rd          , Xu          , Rd          , Xu          , Rd          , Xu          , Rd          , Xu          , Rd          , Cud         , 2 Kud       , Cud         , Rd          , Xu          , Rd          , Xu          , Rd          , Xuc         , Rd          , Xuc         , Rd          , Xuc         , Rd          , Xuc         , Rd          , Xuc         , Rd          , Xu          , Dd          , Dd          , Re          , Dd          , Dd          
Xu          , Xu          , Xu          , Xu          , Xu          , Rd          , Rd          , Rd          , Rd          , Rd          , Xuc         , Rd          , Rd          , Rd          , Xuc         , Rd          , Rd          , Rd          , Xu          , Rd          , Rd          , Cud         , Xu          , Rd          , Rd          , Rd          , Xuc         , Rd          , Rd          , Rd          , Xuc         , Rd          , Rd          , Rd          , Xuc         , Rd          , Rd          , Rd          , Xu          , Dd          , Re          , Re          , Dd          , Dd          
Xu          , Xu          , Xu          , Xu          , Xu          , Xuc         , Rd          , Xuc         , Xuc         , Xuc         , Rd          , Xuc         , Xuc         , Xuc         , Rd          , Xuc         , Xuc         , Xu          , Rd          , Xu          , Xu          , Xu          , Rd          , Xu          , Xu          , Xu          , Rd          , Xuc         , Xuc         , Xuc         , Rd          , Xuc         , Xuc         , Xuc         , Rd          , Xuc         , Xuc         , Xu          , Rrc         , Rrc         , Dd^Do       , Dd          , Dd          , Dd          
Xu          , Xu          , Xu          , Xu          , Xu          , Rd          , Xuc         , Rd          , Xuc         , Rd          , Xuc         , Rd          , Xuc         , Rd          , Xuc         , Rd          , Xuc         , Rd          , Xu          , Rd          , Cud         , Cud         , Cud         , Rd          , Xu          , Rd          , Xuc         , Rd          , Xuc         , Rd          , Xuc         , Rd          , Xuc         , Rd          , Xuc         , Rd          , Xuc         , Rd          , Xu          , Rrc         , Re          , Dd          , Dd          , Dd          
Xu          , Xu          , Xu          , Xu          , Xu          , Rd          , Xuc         , Rd          , Xuc         , Rd          , Xuc         , Rd          , Xuc         , Rd          , Xuc         , Rd          , Xuc         , Rd          , Xu          , Rd          , Cud         , 1 Kud       , Cud         , Rd          , Xu          , Rd          , Xuc         , Rd          , Xuc         , Rd          , Xuc         , Rd          , Xuc         , Rd          , Xuc         , Rd          , Xuc         , Rd          , Xu          , Dd          , Dd          , Re          , Dd          , Dd          
Xu          , Xu          , Xu          , Xu          , Xu          , Rd          , Xuc         , Rd          , Xuc         , Rd          , Xuc         , Rd          , Xuc         , Rd          , Xuc         , Rd          , Xuc         , Rd          , Xu          , Rd          , Rd          , Cud         , Rd          , Rd          , Xu          , Rd          , Xuc         , Rd          , Xuc         , Rd          , Xuc         , Rd          , Xuc         , Rd          , Xuc         , Rd          , Xuc         , Rd          , Xu          , Dd          , Dd          , Re          , Dd          , Dd          
Xu          , Xu          , Xu          , Xu          , Xu          , Rd          , Xuc         , Rd          , Xuc         , Rd          , Xuc         , Rd          , Xuc         , Rd          , Xuc         , Rd          , Xu          , Rd          , Rd          , Xu          , Xu          , Rd          , Xu          , Xu          , Rd          , Rd          , Xuc         , Rd          , Xuc         , Rd          , Xuc         , Rd          , Xuc         , Rd          , Xuc         , Rd          , Xuc         , Rd          , Xu          , Dd          , Dd          , Re          , Dd          , Dd          
Xu          , Xu          , Xu          , Xu          , Xu          , Rd          , Xuc         , Rd          , Xuc         , Rd          , Xuc         , Rd          , Xuc         , Rd          , Xuc         , Rd          , Rd          , Xuc         , Xuc         , Rd          , Rd          , Xu          , Rd          , Rd          , Xuc         , Xuc         , Rd          , Rd          , Xuc         , Rd          , Xuc         , Rd          , Xuc         , Rd          , Xuc         , Rd          , Xuc         , Rd          , Xu          , Dd          , Re          , Re          , Dd          , Dd          
Xu          , Xu          , Xu          , Xu          , Xu          , Rd          , Xuc         , Rd          , Xuc         , Rd          , Xuc         , Rd          , Xuc         , Rd          , Rd          , Xuc         , Xuc         , Rd          , Rd          , Xuc         , Xuc         , Rd          , Xuc         , Xuc         , Rd          , Rd          , Xuc         , Xuc         , Rd          , Rd          , Xuc         , Rd          , Xuc         , Rd          , Xuc         , Rd          , Xuc         , Rd          , Xu          , Re          , Dd          , Dd          , Dd          , Dd          
Xu          , Xu          , Xu          , Xu          , Xu          , Rd          , Xuc         , Rd          , Xuc         , Rd          , Xuc         , Rd          , Rd          , Xuc         , Xuc         , Rd          , Rd          , Xuc         , Xuc         , Rd          , Rd          , Xuc         , Rd          , Rd          , Xuc         , Xuc         , Rd          , Rd          , Xuc         , Xuc         , Rd          , Rd          , Xuc         , Rd          , Xuc         , Rd          , Xuc         , Rd          , Xu          , Re          , Re          , Dd          , Dd          , Dd          
Xu          , Xu          , Xu          , Xu          , Xu          , Rd          , Xuc         , Rd          , Xuc         , Rd          , Rd          , Xuc         , Xuc         , Rd          , Rd          , Xuc         , Xuc         , Rd          , Rd          , Xuc         , Xuc         , Rd          , Xuc         , Xuc         , Rd          , Rd          , Xuc         , Xuc         , Rd          , Rd          , Xuc         , Xuc         , Rd          , Rd          , Xuc         , Rd          , Xuc         , Rd          , Xu          , Dd          , Dd          , Re          , Dd          , Dd          
Xu          , Xu          , Xu          , Xu          , Xu          , Rd          , Xuc         , Rd          , Rd          , Xuc         , Xuc         , Rd          , Rd          , Xuc         , Xuc         , Rd          , Rd          , Xuc         , Xuc         , Rd          , Rd          , Xuc         , Rd          , Rd          , Xuc         , Xuc         , Rd          , Rd          , Xuc         , Xuc         , Rd          , Rd          , Xuc         , Xuc         , Rd          , Rd          , Xuc         , Rd          , Xu          , Dd          , Ce          , Re          , Ce          , Dd          
Xu          , Xu          , Xu          , Xu          , Xu          , Rd          , Rd          , Xuc         , Xuc         , Rd          , Rd          , Xuc         , Xuc         , Rd          , Rd          , Xuc         , Xuc         , Rd          , Rd          , Xuc         , Xuc         , Rd          , Xuc         , Xuc         , Rd          , Rd          , Xuc         , Xuc         , Rd          , Rd          , Xuc         , Xuc         , Rd          , Rd          , Xuc         , Xuc         , Rd          , Rd          , Xu          , Dd          , Dd          , Ce          , Dd          , Dd          
Xu          , Xu          , Xu          , Xu          , Xu          , Xu          , Xu          , Rd          , Rd          , Xuc         , Xuc         , Rd          , Rd          , Xuc         , Xuc         , Rd          , Rd          , Xuc         , Xuc         , Rd          , Rd          , Xuc         , Rd          , Rd          , Xuc         , Xuc         , Rd          , Rd          , Xuc         , Xuc         , Rd          , Rd          , Xuc         , Xuc         , Rd          , Rd          , Xu          , Xu          , Xu          , Dd          , Dd          , 4 Ke        , Dd          , Dd          
Xu          , Xu          , Xu          , Xu          , Xu          , Xu          , Xu          , Xu          , Xu          , Rd          , Rd          , Xuc         , Xuc         , Rd          , Rd          , Xuc         , Xuc         , Rd          , Rd          , Xuc         , Xuc         , Rd          , Xuc         , Xuc         , Rd          , Rd          , Xuc         , Xuc         , Rd          , Rd          , Xuc         , Xuc         , Rd          , Rd          , Xu          , Xu          , Xu          , Xu          , Xu          , Xu          , Xu          , Dd          , Dd          , Dd          
Xu          , Xu          , Xu          , Xu          , Xu          , Xu          , Xu          , Xu          , Xu          , Xu          , Xu          , Rd          , Rd          , Xuc         , Xuc         , Rd          , Rd          , Xuc         , Xuc         , Rd          , Rd          , Xuc         , Rd          , Rd          , Xuc         , Xuc         , Rd          , Rd          , Xuc         , Xuc         , Rd          , Rd          , Xu          , Xu          , Xu          , Xu          , Xu          , Xu          , Xu          , Xu          , Xu          , Xu          , Dd          , Dd          
Xu          , Xu          , Xu          , Xu          , Xu          , Xu          , Xu          , Xu          , Xu          , Xu          , Xu          , Xu          , Xu          , Rd          , Rd          , Xuc         , Xuc         , Rd          , Rd          , Xuc         , Xuc         , Rd          , Xuc         , Xuc         , Rd          , Rd          , Xuc         , Xuc         , Rd          , Rd          , Xu          , Xu          , Xu          , Xu          , Xu          , Xu          , Xu          , Xu          , Xu          , Xu          , Xu          , Xu          , Dd          , Dd          
Xu          , Xu          , Xu          , Xu          , Xu          , Xu          , Xu          , Xu          , Xu          , Xu          , Xu          , Xu          , Xu          , Xu          , Xu          , Rd          , Rd          , Xuc         , Xuc         , Rd          , Rd          , Xuc         , Rd          , Rd          , Xuc         , Xuc         , Rd          , Rd          , Xu          , Xu          , Xu          , Xu          , Xu          , Xu          , Xu          , Xu          , Xu          , Xu          , Xu          , Xu          , Xu          , Xu          , Dd          , Dd          
Xu          , Xu          , Xu          , Xu          , Xu          , Xu          , Xu          , Xu          , Xu          , Xu          , Xu          , Xu          , Xu          , Xu          , Xu          , Xu          , Xu          , Rd          , Rd          , Xuc         , Xuc         , Rd          , Xuc         , Xuc         , Rd          , Rd          , Xu          , Xu          , Xu          , Xu          , Xu          , Xu          , Xu          , Xu          , Xu          , Xu          , Xu          , Xu          , Xu          , Xu          , Xu          , Xu          , Dd          , Dd          
Xu          , Xu          , Xu          , Xu          , Xu          , Xu          , Xu          , Xu          , Xu          , Xu          , Xu          , Xu          , Xu          , Xu          , Xu          , Xu          , Xu          , Xu          , Xu          , Rd          , Rd          , Xuc         , Rd          , Rd          , Xu          , Xu          , Xu          , Xu          , Xu          , Xu          , Xu          , Xu          , Xu          , Xu          , Xu          , Xu          , Xu          , Xu          , Xu          , Xu          , Xu          , Xu          , Dd          , Dd          
Xu          , Xu          , Xu          , Xu          , Xu          , Xu          , Xu          , Xu          , Xu          , Xu          , Xu          , Xu          , Xu          , Xu          , Xu          , Xu          , Xu          , Xu          , Xu          , Xu          , Xu          , Rd          , Xu          , Xu          , Xu          , Xu          , Xu          , Xu          , Xu          , Xu          , Xu          , Xu          , Xu          , Xu          , Xu          , Xu          , Xu          , Xu          , Xu          , Xu          , Xu          , Xu          , Dd          , Dd          
Xu          , Xu          , Xu          , Xu          , Xu          , Xu          , Xu          , Xu          , Xu          , Xu          , Xu          , Xu          , Xu          , Xu          , Xu          , Xu          , Xu          , Xu          , Xu          , Xu          , Xu          , Xu          , Xu          , Xu          , Xu          , Xu          , Xu          , Xu          , Xu          , Xu          , Xu          , Xu          , Xu          , Xu          , Xu          , Xu          , Xu          , Xu          , Xu          , Xu          , Dd          , Dd          , Dd          , Dd          
