border_size=1
usage=map

Xuc, Xuc, Xuc, Xuc, Xuc, Xuc, Xuc, Xuc, Xuc, Xuc, Xuc, Xuc, Xuc, Xuc, Xuc, Xuc, Xuc, Xuc, Xuc, Xuc, Xuc, Xuc, Xuc, Xuc, Xuc, Xuc, Xuc, Xuc, Xuc, Xuc, Xuc, Xuc, Xuc, Xuc, Xuc, Xuc, Xuc, Xuc, Xuc, Xuc, Xuc, Xuc, Xuc, Xuc, Xuc, Xuc, Xuc, Xuc
Xuc, Xuc, Xuc, Xuc, Xuc, Xuc, Xuc, Xuc, Xuc, Xuc, Xuc, Xuc, Xuc, Xuc, Xuc, Xuc, Xuc, Xuc, Xuc, Xuc, Xuc, Xuc, Xuc, Xuc, Xuc, Xuc, Xuc, Xuc, Xuc, Xuc, Xuc, Xuc, Xuc, Xuc, Xuc, Xuc, Xuc, Xuc, Xuc, Xuc, Xuc, Xuc, Xuc, Xuc, Xuc, Xuc, Xuc, Xuc
Xuc, Xuc, Cud, Xuc, Xuc, Xuc, Xuc, Xuc, Xuc, Xuc, Xuc, Xuc, Xuc, Xuc, Xuc, Xuc, Xuc, Xuc, Xuc, Xuc, Xuc, Xuc, Xuc, Xuc, Xuc, Xuc, Xuc, Xuc, Xuc, Xuc, Xuc, Xuc, Xuc, Xuc, Xuc, Xuc, Xuc, Xuc, Xuc, Xuc, Xuc, Xuc, Xuc, Xuc, Xuc, Xuc, Xuc, Xuc
Xuc, Cud, Cud, 2 Kud, Xuc, Xuc, Xuc, Xuc, Xuc, Xuc, Xuc, Xuc, Xuc, Xuc, Xuc, Xuc, Xuc, Xuc, Xuc, Xuc, Xuc, Xuc, Xuc, Xuc, Xuc, Xuc, Xuc, Xuc, Xuc, Xuc, Xuc, Xuc, Xuc, Xuc, Xuc, Xuc, Xuc, Xuc, Xuc, Xuc, Xuc, Xuc, Xuc, Xuc, Xuc, Xuc, Xuc, Xuc
Xuc, Xuc, Cud, Cud, Xuc, Xuc, Uu, Xuc, Uu, Xuc, Uu, Xuc, Uu, Xuc, Uu, Xuc, Rd, Xuc, Re, Xuc, Uu, Xuc, Re, Xuc, Uu, Xuc, Re, Xuc, Re, Xuc, Re, Xuc, Re, Xuc, Uu^Uf, Xuc, Xuc, Xuc, Xuc, Xuc, Xuc, Xuc, Xuc, Xuc, Xuc, Xuc, Xuc, Xuc
Rd, Rd, Rd, Cud, Xuc, Xuc, Re, Uu, Uu, Re, Uu, Uu, Rd, Uu, Rd, Rd, Uu, Uu, Uu, Uu, Uu, Uu, Uu^Uf, Re, Re, Re, Uu, Re, Uu, Uu, Uu, Re, Uu, Re, Uu, Uu, Xuc, Xuc, Xuc, Xuc, Xuc, Xuc, Xuc, Xuc, Xuc, Xuc, Xuc, Xuc
Uu, Uu, Uu, Uu, Xuc, Xuc, Uu, Uu, Xuc, Uu, Re, Uu, Xuc, Rd, Rd, Rd, Xuc, Uu, Re, Re, Xuc, Re, Re, Re, Xuc, Re, Uu^Uf, Re, Xuc, Uu, Uu, Uu, Xuc, Re, Re, Uu, Xuc, Xuc, Xuc, Xuc, Xuc, Xuc, Xuc, Xuc, Xuc, Xuc, Xuc, Xuc
Uu, Rd^Uf, Rd, Uu, Xuc, Xuc, Uu, Uu, Xuc, Xuc, Re, Rd, Xuc, Xuc, Uu, Uu, Xuc, Xuc, Re, Re, Xuc, Xuc, Re, Re, Xuc, Xuc, Wwg, Uu^Uf, Xuc, Xuc, Re, Re, Xuc, Xuc, Re, Uu, Xuc, Xuc, Xuc, Xuc, Xuc, Xuc, Xuc, Xuc, Xuc, Xuc, Xuc, Xuc
Rd^Uf, Uu, Uu, Uu, Xuc, Xuc, Uu, Uu, Re, Xuc, Uu, Uu, Rd, Xuc, Rd, Uu, Rd, Xuc, Re, Re, Re, Xuc, Re, Re, Uu, Xuc, Re, Uu^Uf, Uh, Xuc, Uh, Uh, Re, Xuc, Re, Uu, Xuc, Xuc, Xuc, Xuc, Xuc, Xuc, Xuc, Xuc, Xuc, Xuc, Xuc, Xuc
Xuc, Uu, Uu^Vud, Xuc, Uu, Uu, Uu^Uf, Uu^Uf, Uu^Uf, Re, Re, Rd, Uu, Rd, Rd, Rd, Uu^Uf, Uu^Uf, Re, Uu^Uf, Uu^Uf, Uu^Uf, Re, Re, Uu, Uu, Uu, Re, Uh, Uh, Uh, Uh, Re, Re, Uu^Uf, Uu, Xuc, Xuc, Xuc, Xuc, Xuc, Xuc, Xuc, Xuc, Xuc, Xuc, Xuc, Xuc
Xuc, Uu, Uu, Xuc, Uu, Re, Wwg, Uu^Uf, Xuc, Re, Re, Uu, Xuc, Uu, Re, Rd, Xuc, Uu^Uf, Uu^Uf, Re, Xuc, Re, Re, Uu, Xuc, Uu, Uu, Re, Xuc, Uh, Uh, Re, Xuc, Re, Uu^Uf, Uu, Xuc, Xuc, Xuc, Xuc, Xuc, Xuc, Xuc, Xuc, Xuc, Xuc, Xuc, Xuc
Xuc, Uu, Uu, Uu, Uu, Xuc, Uu^Uf, Re, Xuc, Xuc, Re, Re, Xuc, Xuc, Re, Re, Xuc, Xuc, Uu^Uf, Re, Xuc, Xuc, Rd, Uu, Xuc, Xuc, Re, Re, Xuc, Xuc, Uh, Uh, Xuc, Xuc, Uu^Uf, Re, Xuc, Xuc, Xuc, Xuc, Xuc, Xuc, Xuc, Xuc, Xuc, Xuc, Xuc, Xuc
Xuc, Xuc, Xuc, Uu, Xuc, Xuc, Re, Re, Re, Xuc, Re, Re, Re, Xuc, Re, Uu, Re, Xuc, Uu^Uf, Re, Uu, Xuc, Rd, Uu, Rd, Xuc, Re, Re, Uh, Xuc, Uh, Uh, Re, Xuc, Uu^Uf, Re, Xuc, Xuc, Xuc, Xuc, Xuc, Xuc, Xuc, Xuc, Xuc, Xuc, Xuc, Xuc
Xuc, Xuc, Xuc, Xuc, Xuc, Xuc, Re, Uu, Re, Re, Uu, Uu, Re, Re^Uf, Uu^Uf, Uu^Uf, Uu^Uf, Uu^Uf, Rd, Rd, Rd, Rd, Rd, Rd, Rd, Rd, Uu, Uh, Uh, Uh, Uh, Uu^Uf, Uu^Uf, Uu^Uf, Re, Uu, Xuc, Xuc, Xuc, Xuc, Xuc, Xuc, Xuc, Xuc, Xuc, Xuc, Xuc, Xuc
Xuc, Xuc, Xuc, Xuc, Xuc, Xuc, Uu, Uu, Xuc, Re, Uu, Uu, Xuc, Uu^Uf, Re, Wwg, Xuc, Re, Rd, Rd, Xuc, Re, Uu, Uu, Xuc, Re, Uh, Uh, Xuc, Uh, Re, Uu^Uf, Xuc, Re, Re, Re, Xuc, Xuc, Xuc, Xuc, Xuc, Xuc, Xuc, Xuc, Xuc, Xuc, Xuc, Xuc
Xuc, Xuc, Xuc, Xuc, Xuc, Xuc, Uu, Uu, Xuc, Xuc, Re, Re, Xuc, Xuc, Re, Re, Xuc, Xuc, Re, Re, Xuc, Xuc, Uu, Re, Xuc, Xuc, Uh, Uh, Xuc, Xuc, Uu, Re, Xuc, Xuc, Uu, Uu, Xuc, Xuc, Xuc, Xuc, Xuc, Xuc, Xuc, Xuc, Xuc, Xuc, Xuc, Xuc
Xuc, Xuc, Xuc, Xuc, Xuc, Xuc, Uu, Uu, Uu, Xuc, Uu, Re, Uu, Xuc, Uu^Uf, Uu, Uu, Xuc, Uu, Re, Re, Xuc, Re, Re, Uu, Xuc, Uh, Uh, Re, Xuc, Re, Re, Re, Xuc, Re, Re, Xuc, Xuc, Xuc, Xuc, Xuc, Xuc, Xuc, Xuc, Xuc, Xuc, Xuc, Xuc
Xuc, Xuc, Xuc, Xuc, Xuc, Xuc, Re, Re, Uu, Re, Uu, Uu^Uf, Uu, Uu, Uu, Uu, Re, Re, Re, Re, Rd, Uu, Uu, Re, Re, Re, Uu, Re, Re, Uu, Uu, Uu, Uu, Uu, Uu, Re, Rr, Xuc, Xuc, Xuc, Ds, Xuc, Xuc, Xuc, Xuc, Xuc, Xuc, Xuc
Xuc, Xuc, Xuc, Xuc, Xuc, Xuc, Re, Uu, Xuc, Re, Re, Uu, Xuc, Uu, Uu, Re, Xuc, Re, Re, Uu, Xuc, Rd, Uu, Re, Xuc, Re, Re, Re, Xuc, Re, Re, Re, Xuc, Uu, Uu, Uu, Rr, Rr, Rr, Wwg, Re^Uf, Re, Re, Xuc, Xuc, Xuc, Xuc, Xuc
Xuc, Xuc, Xuc, Xuc, Xuc, Xuc, Uu, Re, Xuc, Xuc, Re, Re, Xuc, Xuc, Uu, Uu, Xuc, Xuc, Uu, Uu, Xuc, Xuc, Uu, Uu, Xuc, Xuc, Uu^Uf, Uu, Xuc, Xuc, Rd, Re, Xuc, Xuc, Uu, Uu, Xuc, Rr, Rr, Rr, Wwg, Re, Cud, Ds^Uf, Ds, Xuc, Xuc, Xuc
Xuc, Xuc, Xuc, Xuc, Xuc, Xuc, Re, Uu, Uu^Uf, Xuc, Re, Re, Re, Xuc, Uu, Re, Uu, Xuc, Re, Re, Uu, Xuc, Rd, Uu, Rd, Xuc, Uu^Uf, Uu^Uf, Rd, Xuc, Rd, Uu, Re, Xuc, Re, Uu, Xuc, Xuc, Rr, Rr, Cud, Cud, 3 Kud, Cud, Ds^Fetd, Xuc, Xuc, Xuc
Xuc, Xuc, Xuc, Xuc, Xuc, Xuc, Uu^Uf, Uu^Uf, Re, Uu^Uf, Uu, Uu, Uu, Uu, Rd, Re, Re, Re, Re, Rd, Rd, Uu^Uf, Uu, Rd, Re, Re, Uu, Uu^Uf, Uu^Uf, Uu^Uf, Uu^Uf, Rd, Re, Re, Re, Uu, Xuc, Xuc, Rr, Rr, Wwg, Cud, Cud, Cud, Xuc, Xuc, Xuc, Xuc
Xuc, Xuc, Xuc, Xuc, Xuc, Xuc, Uu, Re, Xuc, Re, Uu, Re, Xuc, Rd, Rd, Uu, Xuc, Re, Uu, Re, Xuc, Uu, Rd, Rd, Xuc, Re, Rd, Rd, Xuc, Uu^Uf, Re, Uu^Uf, Xuc, Re, Re, Uu, Xuc, Xuc, Rr, Rr, Re, Wwg, Re, Re, Xuc, Xuc, Xuc, Xuc
Xuc, Xuc, Xuc, Xuc, Xuc, Xuc, Re, Re, Xuc, Xuc, Re, Re, Xuc, Xuc, Rd, Rd, Xuc, Xuc, Uu, Uu, Xuc, Xuc, Uu, Uu, Xuc, Xuc, Rd, Rd, Xuc, Xuc, Re, Re, Xuc, Xuc, Re, Uu, Xuc, Xuc, Rr, Rr, Re, Re, Re, Re^Uf, Xuc, Xuc, Xuc, Xuc
Xuc, Xuc, Xuc, Xuc, Xuc, Xuc, Uu, Uu, Uu, Xuc, Re, Re, Re, Xuc, Rd, Rd, Re, Xuc, Uu, Uu, Re, Xuc, Re, Uu, Uu, Xuc, Re, Rd, Re, Xuc, Uu, Uu, Uu, Xuc, Re, Re, Xuc, Xuc, Rr, Rr, Xuc, Re, Re, Xuc, Xuc, Xuc, Xuc, Xuc
Xuc, Xuc, Xuc, Xuc, Xuc, Xuc, Rd, Re, Re, Re, Uu, Uu, Uu, Uu, Uu, Rd, Uu, Uu, Uu, Uu, Re, Re, Re, Uu, Re, Uu, Uu, Uu, Re, Re, Uu, Uu, Uu, Uu, Uu, Re, Xuc, Xuc, Rr, Rr, Rr, Xuc, Xuc, Xuc, Xuc, Xuc, Md^Xm, Md^Xm
Xuc, Xuc, Xuc, Xuc, Xuc, Xuc, Uu^Uf, Uu^Uf, Xuc, Re, Re, Uu, Xuc, Re, Uu, Uu, Xuc, Re, Re, Re, Xuc, Re, Uh, Re, Xuc, Re, Re, Re, Xuc, Uu, Re, Re, Xuc, Re, Uu^Uf, Uu^Uf, Xuc, Xuc, Xuc, Rr, Rr, Xuc, Xuc, Xuc, Md^Xm, Md^Xm, Md^Xm, Md^Xm
Xuc, Xuc, Xuc, Xuc, Xuc, Xuc, Uu, Rd, Xuc, Xuc, Re, Re, Xuc, Xuc, Re, Re, Xuc, Xuc, Re, Re, Xuc, Xuc, Uh, Uh, Xuc, Xuc, Re, Re, Xuc, Xuc, Uu^Uf, Re, Xuc, Xuc, Wwg, Uu^Uf, Xuc, Xuc, Xuc, Rr, Rr, Xuc, Xuc, Xuc, Md^Xm, Md^Xm, Md^Xm, Md^Xm
Xuc, Xuc, Xuc, Xuc, Xuc, Xuc, Rd, Rd, Re, Xuc, Re, Uu^Uf, Uu, Xuc, Re, Re, Re, Xuc, Re, Uu, Re, Xuc, Uh, Uh, Uh, Xuc, Uh, Re, Re, Xuc, Re, Uu, Re, Xuc, Re, Uu^Uf, Xuc, Xuc, Xuc, Rr, Rr, Xuc, Md^Xm, Md^Xm, Dd, Ds, Dd^Do, Ds
Xuc, Xuc, Xuc, Xuc, Xuc, Xuc, Rd, Rd, Rd, Rd, Re, Uu, Uu, Uu^Uf, Uu, Re, Uu^Uf, Re, Re, Re, Uh, Uh, Uh, Uu^Uf, Uh, Uh, Uu^Uf, Uh, Uh, Uu, Re, Re, Re, Uu^Uf, Uu^Uf, Uu^Uf, Xuc, Xuc, Xuc, Rr, Rr, Xuc, Dd, Dd, Ds, Ds, Ds, Ds
Xuc, Xuc, Xuc, Xuc, Xuc, Xuc, Xuc, Uu, Xuc, Re, Xuc, Uu^Uf, Xuc, Uu^Uf, Re, Uu^Uf, Xuc, Re, Xuc, Re, Xuc, Uh, Xuc, Uh, Xuc, Uh, Uh, Uh, Xuc, Uh, Xuc, Re, Xuc, Re, Xuc, Re, Xuc, Xuc, Xuc, Rr, Rr, Rr, Rr, Dd, Rr, Ds, Rr, Ds
Xuc, Xuc, Xuc, Xuc, Xuc, Xuc, Xuc, Xuc, Xuc, Xuc, Xuc, Xuc, Xuc, Xuc, Re, Re, Xuc, Xuc, Xuc, Xuc, Xuc, Xuc, Xuc, Xuc, Xuc, Xuc, Uu^Uf, Uh, Xuc, Xuc, Xuc, Xuc, Xuc, Xuc, Xuc, Xuc, Xuc, Xuc, Xuc, Rr, Rr, Rr, Rr, Rr, Hd, Rr, Hd, Rr
Xuc, Xuc, Xuc, Xuc, Xuc, Xuc, Uu, Xuc, Re, Xuc, Re, Xuc, Re, Xuc, Uu, Uu, Uu, Xuc, Re, Xuc, Uh, Xuc, Re, Xuc, Uu, Xuc, Uh, Uh, Re, Xuc, Re, Xuc, Wwg, Xuc, Re, Xuc, Xuc, Xuc, Xuc, Rr, Rr, Rr, Hd, Hd, Hd, Hd, Hd, Hd
Xuc, Xuc, Xuc, Xuc, Xuc, Xuc, Uu, Re, Uu, Uu, Uu, Re, Re, Re, Uu, Re, Re, Uu, Re, Uh, Uh, Uh, Re, Re, Re, Uh, Uu^Uf, Uh, Uh, Uu, Uu, Uu, Uu, Re, Re, Uu, Xuc, Xuc, Xuc, Rr, Rr, Xuc, Md^Xm, Hd, Hd, Hd, Hd, Hd
Xuc, Xuc, Xuc, Xuc, Xuc, Xuc, Re, Re, Xuc, Uu, Uu, Uu, Xuc, Uu, Uu, Re, Xuc, Re, Re, Uh, Xuc, Uh, Re, Re, Xuc, Uh, Uh, Uh, Xuc, Uu^Uf, Uh, Re, Xuc, Re, Re, Re, Xuc, Xuc, Xuc, Rr, Rr, Xuc, Xuc, Md^Xm, Md^Xm, Hd, Hd, Hd
Xuc, Xuc, Xuc, Xuc, Xuc, Xuc, Rd, Rd, Xuc, Xuc, Uu, Uu, Xuc, Xuc, Re, Re, Xuc, Xuc, Uu, Re, Xuc, Xuc, Re, Re, Xuc, Xuc, Rd, Uh, Xuc, Xuc, Uh, Re, Xuc, Xuc, Uu, Re, Xuc, Xuc, Xuc, Rr, Rr, Xuc, Xuc, Md^Xm, Md^Xm, Md^Xm, Md^Xm, Hd
Xuc, Xuc, Xuc, Xuc, Xuc, Xuc, Rd, Rd, Rd, Xuc, Rd, Rd, Wwg, Xuc, Re, Re, Re, Xuc, Uu, Uu, Re, Xuc, Uu, Re, Uu, Xuc, Rd, Rd, Uu, Xuc, Uu, Uu, Uu, Xuc, Uu, Re, Xuc, Xuc, Xuc, Rr, Rr, Xuc, Xuc, Xuc, Xuc, Md^Xm, Md^Xm, Md^Xm
Xuc, Xuc, Xuc, Xuc, Xuc, Xuc, Re, Rd, Uh, Re, Re, Rd, Uu, Uu, Uh, Re, Uh, Re, Uh, Uu, Re, Uu, Uu, Uu, Re, Rd, Rd, Re, Uu, Uu, Re, Uu, Uu, Uu, Re, Re, Xuc, Xuc, Xuc, Rr, Rr, Xuc, Xuc, Xuc, Xuc, Md^Xm, Md^Xm, Md^Xm
Xuc, Xuc, Xuc, Xuc, Xuc, Xuc, Re, Uh, Xuc, Uh, Re, Re, Xuc, Uh, Uh, Uu^Uf, Xuc, Uh, Uh, Uh, Xuc, Uu, Uu, Re, Xuc, Re, Re, Uu, Xuc, Uu, Uu, Re, Xuc, Uu, Re, Re, Xuc, Xuc, Xuc, Rr, Rr, Xuc, Xuc, Xuc, Xuc, Xuc, Xuc, Md^Xm
Xuc, Xuc, Xuc, Xuc, Xuc, Xuc, Uu, Uh, Xuc, Xuc, Re, Re, Xuc, Xuc, Uh, Uh, Xuc, Xuc, Uh, Uh, Xuc, Xuc, Re, Re, Xuc, Xuc, Re, Re, Xuc, Xuc, Re, Re, Xuc, Xuc, Re, Wwg, Xuc, Xuc, Rr, Rr, Rr, Re^Uf, Re, Xuc, Xuc, Xuc, Xuc, Xuc
Xuc, Xuc, Xuc, Xuc, Xuc, Xuc, Uu, Re, Re, Xuc, Re, Re, Uu, Xuc, Uu, Uh, Re, Xuc, Re, Rd, Rd, Xuc, Re, Re, Re, Xuc, Uh, Re, Re, Xuc, Uu, Re, Rd, Xuc, Re, Uu, Xuc, Xuc, Rr, Rr, Re, Re, Cud, Cud, Xuc, Xuc, Xuc, Xuc
Xuc, Xuc, Xuc, Xuc, Xuc, Xuc, Re, Re, Re, Re, Rd, Re, Rd, Uu, Re, Re, Re, Re, Re, Rd, Rd, Rd, Uh, Uh, Uh, Uh, Uh, Uh, Re, Re, Re, Rd, Rd, Rd, Re, Re, Xuc, Xuc, Rr, Rr, Re, Cud, Cud, 4 Kud, Re^Uf, Xuc, Xuc, Xuc
Xuc, Xuc, Xuc, Xuc, Xuc, Xuc, Re, Re, Xuc, Rd, Rd, Rd, Xuc, Rd, Rd, Re, Xuc, Re, Re, Re, Xuc, Re, Uh, Uh, Xuc, Uu^Uf, Uh, Uh, Xuc, Re, Re, Rd, Xuc, Rd, Uh, Re, Xuc, Xuc, Rr, Rr, Re, Cud, Cud, Cud, Wwg, Xuc, Xuc, Xuc
Xuc, Xuc, Xuc, Xuc, Xuc, Xuc, Uu, Uu, Xuc, Xuc, Rd, Rd, Xuc, Xuc, Rd, Re, Xuc, Xuc, Wwg, Uu, Xuc, Xuc, Re, Uu^Uf, Xuc, Xuc, Uh, Uh, Xuc, Xuc, Re, Uu, Xuc, Xuc, Uh, Uh, Xuc, Xuc, Rr, Rr, Re^Fetd, Wwg, Wwg, Wwg, Xuc, Xuc, Xuc, Xuc
Xuc, Xuc, Xuc, Xuc, Xuc, Xuc, Re, Uu, Uu, Xuc, Re, Rd, Re, Xuc, Re, Re, Re, Xuc, Uu, Uu, Wwg, Xuc, Uu, Uh, Uh, Xuc, Uu, Re, Re, Xuc, Re, Re, Re, Xuc, Uh, Uu^Uf, Rr, Rr, Rr, Rr, Re, Re, Re, Re^Uf, Xuc, Xuc, Xuc, Xuc
Xuc, Xuc, Xuc, Xuc, Xuc, Xuc, Re, Uu, Re, Uu, Uu, Uu, Uu, Re, Uh, Uh, Uh, Re, Re, Uu, Re, Uu, Re, Re, Uu, Uu, Re, Re, Uh, Uu, Re, Re, Re, Uh, Uh, Uh, Rr, Rr, Xuc, Xuc, Xuc, Xuc, Xuc, Xuc, Xuc, Xuc, Xuc, Xuc
Xuc, Xuc, Xuc, Xuc, Xuc, Xuc, Re, Re, Xuc, Uu, Uu, Uu, Xuc, Re, Re, Uh, Xuc, Uh, Re, Rd, Xuc, Uu, Uu, Re, Xuc, Re, Re, Uh, Xuc, Uh, Re, Re, Xuc, Uh, Uh, Uh, Xuc, Xuc, Xuc, Xuc, Xuc, Xuc, Xuc, Xuc, Xuc, Xuc, Xuc, Xuc
Xuc, Xuc, 1 Kud, Xuc, Xuc, Xuc, Uu, Re, Xuc, Xuc, Re, Uu, Xuc, Xuc, Re, Uh, Xuc, Xuc, Uh, Rd, Xuc, Xuc, Re, Uu, Xuc, Xuc, Uu, Uh, Xuc, Xuc, Re, Re, Xuc, Xuc, Re, Uu, Xuc, Xuc, Xuc, Xuc, Xuc, Xuc, Xuc, Xuc, Xuc, Xuc, Xuc, Xuc
Xuc, Cud, Cud, Xuc, Xuc, Xuc, Re, Uu, Re, Xuc, Re, Rd, Rd, Xuc, Re, Re, Uu^Uf, Xuc, Uh, Re, Re, Xuc, Uu, Uu, Uu, Xuc, Rd, Rd, Rd, Xuc, Re, Re, Re, Xuc, Re, Re, Xuc, Xuc, Xuc, Xuc, Xuc, Xuc, Xuc, Xuc, Xuc, Xuc, Xuc, Xuc
Xuc, Cud, Cud, Cud, Xuc, Xuc, Re, Re, Re, Re, Rd, Re, Re, Re, Re, Re, Uh, Uh, Uh, Re, Rd, Rd, Rd, Re, Re, Rd, Rd, Rd, Rd, Re, Re, Re, Rd, Re, Re, Re, Xuc, Xuc, Xuc, Xuc, Xuc, Xuc, Xuc, Xuc, Xuc, Xuc, Xuc, Xuc
Xuc, Xuc, Rr, Cud, Xuc, Xuc, Re, Re, Xuc, Rd, Rd, Rd, Xuc, Re, Re, Uh, Xuc, Uh, Uh, Uh, Xuc, Rd, Rd, Rd, Xuc, Uu, Uu, Rd, Xuc, Wwg, Uu, Rd, Xuc, Rd, Uu, Re, Xuc, Xuc, Xuc, Xuc, Xuc, Xuc, Xuc, Xuc, Xuc, Xuc, Xuc, Xuc
Rr, Rr, Rr, Rr, Xuc, Xuc, Re, Uu, Xuc, Xuc, Rd, Rd, Xuc, Xuc, Re, Uh, Xuc, Xuc, Uh, Uh, Xuc, Xuc, Rd, Rd, Xuc, Xuc, Uu, Re, Xuc, Xuc, Re, Rd, Xuc, Xuc, Uu, Re, Xuc, Xuc, Xuc, Xuc, Xuc, Xuc, Xuc, Xuc, Xuc, Xuc, Xuc, Xuc
Rr, Rr, Rr, Xuc, Xuc, Xuc, Uu, Uu, Uu, Xuc, Re, Re, Re, Xuc, Rd, Re, Re, Xuc, Uh, Uu^Uf, Uh, Xuc, Re, Re, Uu, Xuc, Uh, Uu, Rd, Xuc, Re, Re, Re, Xuc, Re, Re, Xuc, Xuc, Xuc, Xuc, Xuc, Xuc, Xuc, Xuc, Xuc, Xuc, Xuc, Xuc
Xuc, Rr, Rr, Xuc, Xuc, Xuc, Re, Re, Uu, Uu, Re, Re, Re, Rd, Uu, Re, Uu, Re, Rd, Uh, Uh, Uh, Re, Re, Uh, Uh, Uu^Uf, Uh, Rd, Rd, Rd, Re, Re, Re, Re, Re, Xuc, Xuc, Xuc, Xuc, Xuc, Xuc, Xuc, Xuc, Xuc, Xuc, Xuc, Xuc
Xuc, Rr, Rr, Xuc, Xuc, Xuc, Re, Uu, Xuc, Wwg, Uu, Re, Xuc, Re, Uu, Uu, Xuc, Uu, Rd, Rd, Xuc, Uu, Uu, Uh, Xuc, Uh, Uh, Uh, Xuc, Rd, Rd, Re, Xuc, Rd, Rd, Re, Xuc, Xuc, Xuc, Xuc, Xuc, Xuc, Xuc, Xuc, Xuc, Xuc, Xuc, Xuc
Xuc, Rr, Wwg, Rr, Rr, Xuc, Re, Uu, Xuc, Xuc, Re, Rd, Xuc, Xuc, Re, Uu, Xuc, Xuc, Re, Rd, Xuc, Xuc, Uh, Uh, Xuc, Xuc, Uh, Uh, Xuc, Xuc, Uu, Wwg, Xuc, Xuc, Rd, Uu, Xuc, Xuc, Xuc, Xuc, Xuc, Xuc, Xuc, Xuc, Xuc, Xuc, Xuc, Xuc
Xuc, Xuc, Xuc, Uu^Uf, Rr, Xuc, Re, Re, Re, Xuc, Re, Rd, Uu, Xuc, Uu, Uu, Re, Xuc, Re, Uu, Uu, Xuc, Uh, Uh, Uh, Xuc, Uh, Uh, Uh, Xuc, Re, Re, Uu, Xuc, Re, Re, Xuc, Xuc, Xuc, Xuc, Xuc, Xuc, Xuc, Xuc, Xuc, Xuc, Xuc, Xuc
Xuc, Xuc, Xuc, Uu, Rr, Rr, Re, Re, Re, Re, Re, Re, Re, Uu, Uu, Re, Uu, Uu, Re, Re, Re, Uh, Uh, Uu^Uf, Uh, Uh, Uh, Uh, Rd, Rd, Re, Re, Re, Re, Re^Uf, Re, Xuc, Xuc, Xuc, Xuc, Xuc, Xuc, Xuc, Xuc, Xuc, Xuc, Xuc, Xuc
Xuc, Xuc, Xuc, Uu^Vu, Xuc, Rr, Xuc, Uu, Xuc, Re, Xuc, Re, Xuc, Re, Xuc, Re, Xuc, Re, Xuc, Re, Xuc, Uh, Xuc, Uh, Xuc, Uh, Xuc, Uh, Xuc, Rd, Xuc, Re, Xuc, Re, Xuc, Re, Xuc, Xuc, Xuc, Xuc, Xuc, Xuc, Xuc, Xuc, Xuc, Xuc, Xuc, Xuc
Xuc, Xuc, Xuc, Xuc, Xuc, Xuc, Xuc, Xuc, Xuc, Xuc, Xuc, Xuc, Xuc, Xuc, Xuc, Xuc, Xuc, Xuc, Xuc, Xuc, Xuc, Xuc, Xuc, Xuc, Xuc, Xuc, Xuc, Xuc, Xuc, Xuc, Xuc, Xuc, Xuc, Xuc, Xuc, Xuc, Xuc, Xuc, Xuc, Xuc, Xuc, Xuc, Xuc, Xuc, Xuc, Xuc, Xuc, Xuc
