Mdd^Xm, Mdd^Xm, Mdd^Xm, Mdd^Xm, Mdd^Xm, Mdd^Xm, Mdd^Xm, Mdd^Xm, Mdd^Xm, Mdd^Xm, Mdd^Xm, Mdd^Xm, Mdd^Xm, Mdd^Xm, Mdd^Xm, Mdd^Xm, Mdd^Xm, Mdd^Xm, Mdd^Xm, Mdd^Xm, Mdd^Xm, Mdd^Xm, Mdd^Xm, Mdd^Xm, Mdd^Xm, Mdd^Xm, Mdd^Xm, Mdd^Xm, Mdd^Xm, Mdd^Xm, Mdd^Xm, Mdd^Xm, Mdd^Xm, Mdd^Xm, Mdd^Xm, Mdd^Xm, Mdd^Xm, Mdd^Xm, Mdd^Xm, Mdd^Xm, Mdd^Xm, Mdd^Xm, Mdd^Xm, Mdd^Xm, Mdd^Xm, Mdd^Xm, Mdd^Xm, Mdd^Xm, Mdd^Xm, Mdd^Xm, Mdd^Xm, Mdd^Xm, Mdd^Xm, Mdd^Xm, Mdd^Xm, Mdd^Xm, Mdd^Xm, Mdd^Xm, Mdd^Xm, Mdd^Xm, Mdd^Xm, Mdd^Xm
Mdd^Xm, Mdd^Xm, Mdd^Xm, Mdd^Xm, Mdd^Xm, Mdd^Xm, Mdd^Xm, Mdd^Xm, Ds, Mdd^Xm, Ds, Mdd^Xm, Ds, Mdd, Mdd^Xm, Mdd^Xm, Mdd^Xm, Mdd^Xm, Ds, Mdd, Mdd^Xm, Mdd^Xm, Mdd, Mdd^Xm, Mdd, Mdd^Xm, Mdd^Xm, Mdd^Xm, Mdd^Xm, Mdd^Xm, Mdd^Xm, Mdd^Xm, Mdd^Xm, Mdd^Xm, Mdd^Xm, Mdd^Xm, Ds, Mdd^Xm, Mdd^Xm, Mdd^Xm, Mdd^Xm, Mdd^Xm, Ds, Mdd^Xm, Ds, Mdd^Xm, Ds, Mdd^Xm, Ds, Mdd^Xm, Dd, Mdd^Xm, Ds, Ds, Ds, Mdd^Xm, Ds, Mdd^Xm, Mdd^Xm, Mdd^Xm, Mdd^Xm, Mdd^Xm
Mdd^Xm, Mdd^Xm, Mdd^Xm, Mdd^Xm, Mdd^Xm, Mdd, Ds, Ds, Hd, Ds, Ds, Ds, Ds^Edp, Ds, Ds, Ds, Ds, Ds, Ds, Ds, Hd, Ds, Ds, Mdd^Xm, Ds, Mdd^Xm, Mdd^Xm, Mdd^Xm, Mdd^Xm, Mdd^Xm, Mdd^Xm, Ds^Edp, Ds, Ds, Ds, Ds, Ds, Ds, Ds, Mdd^Xm, Mdd, Ds, Ds^Es, Ds, Ds, Ds, Ds, Ds, Ds, Ds, Dd, Dd, Dd, Dd, Ds, Ds, Ds, Ds, Ds, Mdd^Xm, Mdd^Xm, Mdd^Xm
Mdd^Xm, Mdd^Xm, Mdd^Xm, Mdd^Xm, Mdd^Xm, Mdd^Xm, Ds, Hd, Hd, Hd, Ds, Ds, Ds, Ds, Hd, Ds, Ds, Ds, Ds, Ds, Hd, Ds, Ds, Ds, Ds, Mdd^Xm, Ds, Ds, Ds, Mdd, Ds, Ds, Ds, Ds, Ds, Ds, Dd, Dd, Ds, Ds, Ds, Ds, Ds, Ds, Hd, Ds, Ds, Ds, Ds, Dd, Dd, Dd^Edp, Dd^Edp, Dd, Dd, Ds, Ds, Ds, Ds, Ds^Edp, Mdd, Mdd^Xm
Mdd^Xm, Mdd^Xm, Mdd^Xm, Mdd, Ds, Ds, Ds, Hd, Hd, Ds, Dd, Ds, Hd, Ds, Ds, Ds, Ds, Dd^Vda, Ds, Ds, Hd, Ds, Ds, Ds, Ds, Ds, Ds, Ds, Ds, Ds, Hd, Hd, Hd, Hd, Dd, Dd, Dd, Dd, Ds, Ds, Dd, Dd, Dd, Ds, Ds, Hd, Hd, Hd, Ds, Dd, Dd, Dd^Edp, Dd, Dd, Hd, Ds, Hd, Ds, Ds, Ds, Ds, Mdd^Xm
Mdd^Xm, Mdd^Xm, Mdd^Xm, Mdd^Xm, Ds^Edp, Ds, Ds, Hd, Ds, Ds, Dd, Dd, Dd^Dc, Hd, Ds, Dd, Dd, Dd, Hd, Hd, Gd, Gd, Gd^Ft, Gs, Cte, Ds, Ds, Ds, Ds, Hd, Hd, Hd, Hd, Hd, Dd, Dd^Es, Dd, Dd, Ds, Ds, Dd, Dd^Dc, Dd, Dd, Ds, Hd, Hd, Hd, Hd, Ds, Ds, Dd, Ds, Ds, Ds, Hd, Hd, Hd, Ds, Dd, Dd, Mdd^Xm
Mdd^Xm, Mdd^Xm, Mdd^Xm, Mdd, Ds, Ds, Ds, Ds, Ds, Ds, Dd, Dd, Hd, Hd, Ds, Ds, Hd, Dd, Dd^Fi|, Wwr, Wwt, Wwt, Ww^Bw\, Gd^Ft, Cte, Ds^Edp, Ds, Ds, Dd, Dd, Dd, Hd, Ds, Ds, Ds, Dd, Ds, Ds, Ds, Dd, Dd^Do, Dd, Dd, Dd, Ds, Hd, Hd, Hd, Ds, Ds, Ds, Ds, Ds, Ds, Hd, Hd, Hd, Hd, Ds, Dd, Dd^Edp, Mdd^Xm
Mdd^Xm, Mdd^Xm, Mdd^Xm, Mdd^Xm, Ds, Ds, Ds, Dd, Dd, Dd, Dd^Do, Ds, Ds, Ds, Hd, Ds, Ds, Hd, Ds, Wwt, Wwt, Wwt, Cte, 3 Kte, Cte, Dd^Vdt, Ds, Ds, Dd, Dd, Dd^Dc, Dd, Ds, Ds^Edp, Ds, Ds, Ds, Ds, Hd, Ds, Ds, Ds, Ds, Ds, Ds, Ds, Ds, Ds, Ds, Ds, Dd, Dd, Dd, Ds, Hd, Hd, Hd, Hd, Ds, Dd, Ds, Mdd^Xm
Mdd^Xm, Mdd^Xm, Mdd^Xm, Mdd, Mdd^Xm, Ds, Ds, Dd, Dd, Dd^Edp, Dd, Ds, Hd, Hd, Hd, Ds, Ds, Hd, Ds, Ds, Ds, Cte, Ds, Cte, Ds, Ds, Ds, Ds, Ds, Dd, Dd, Dd, Ds, Ds, Ds, Ds, Hd, Hd, Hd, Ds, Ds, Ds, Dd, Ds, Ds, Ds, Ds, Ds, Dd, Dd, Dd^Edp, Dd^Edp, Dd, Ds, Dd^Do, Ds, Ds, Ds, Ds, Dd^Edp, Ds, Mdd^Xm
Mdd^Xm, Mdd^Xm, Mdd^Xm, Mdd^Xm, Mdd, Mdd, Ds, Ds, Dd, Dd, Dd, Ds, Hd, Ds, Dd, Ds, Ds, Dd, Dd, Ds, Dd^Vda, Ds, Ds, Ds, Ds, Ds, Ds, Ds, Ds, Dd, Ds, Dd, Ds, Ds, Ds, Hd, Hd, Hd, Hd, Ds, Ds, Ds, Dd, Dd, Dd, Ds, Ds, Ds, Dd, Dd, Dd, Dd, Ds, Ds, Ds, Ds, Ds, Ds, Ds, Ds, Mdd, Mdd^Xm
Mdd^Xm, Mdd^Xm, Mdd^Xm, Mdd^Xm, Mdd^Xm, Ds^Edp, Ds, Ds, Ds, Ds, Ds, Dd, Dd, Dd, Dd, Ds, Ds, Dd, Dd, Ds, Ds, Ds, Ds, Ds, Ds, Ds, Mdd^Xm, Mdd^Xm, Mdd^Xm, Ds, Ds, Ds, Ds, Ds, Ds, Hd, Hd, Hd, Ds, Ds, Ds, Dd, Dd^Es, Dd^Dc, Dd^Es, Dd, Ds, Ds, Ds, Ds, Dd, Ds, Ds, Ds, Ds, Dd, Ds, Ds, Ds, Ds, Mdd^Xm, Mdd^Xm
Mdd^Xm, Mdd^Xm, Mdd^Xm, Mdd^Xm, Mdd, Ds, Ds, Hd, Hd, Ds, Ds, Dd, Dd, Dd^Es, Dd, Ds, Dd, Ds, Ds, Ds, Ds, Ds, Ds^Edp, Mdd^Xm, Mdd^Xm, Mdd^Xm, Ds, Mdd^Xm, Ds^Edpp, Mdd^Xm, Mdd^Xm, Ds, Ds, Ds, Ds, Ds, Ds, Ds, Ds, Ds, Ds, Dd, Dd, Dd, Dd, Ds, Ds, Ds, Ds, Ds, Ds, Ds, Cd, Ds, Cd, Ds, Ds, Ds, Ds, Ds, Mdd^Xm, Mdd^Xm
Mdd^Xm, Mdd^Xm, Mdd^Xm, Mdd^Xm, Ds, Ds, Ds, Hd, Ds^Edp, Hd, Hd, Ds, Ds, Dd, Ds, Dd, Dd, Ds, Ds, Ds, Ds^Edp, Ds, Mdd^Xm, Mdd^Xm, Dd, Dd, Rr, Rr, Rr, Ds, Dd^Vdt, Mdd^Xm, Mdd^Xm, Mdd^Xm, Mdd^Xm, Ds, Ds, Ds, Ds, Ds, Ds, Ds, Ds, Dd, Ds, Ds, Ds, Ds, Ds, Ds, Ds, Cd, Ds, Cd, Ds, Cd, Ds, Ds, Ds, Ds, Mdd, Mdd^Xm
Mdd^Xm, Mdd^Xm, Mdd^Xm, Mdd, Ds, Ds, Ds, Hd, Ds, Ds, Ds, Ds, Ds, Ds, Dd, Dd, Dd, Ds, Mdd^Xm, Mdd^Xm, Mdd^Xm, Mdd^Xm, Dd^Ftd, Dd, Dd^Vda, Rr, Gs^Ft, Gs^Ft, Gs^Ft, Rr, Rr, Ds, Dd^Do, Ds, Ch, Mdd^Xm, Mdd^Xm, Ds, Ds, Ds, Ds, Ds, Ds, Ds, Ds, Ds, Cd, Cd, Ds, Ds^Edpp, Gd, Gs, Rd, Rd, Ds^Edpp, Ds, Dd^Ft, Ds, Ds, Dd^Vda, Mdd^Xm, Mdd^Xm
Ds, Mdd, Ds, Ds, Ce, Ds, Ds, Ds, Ds, Ds, Ds, Ds, Dd, Dd, Dd^Dc, Dd, Ds, Ds, Mdd^Xm, Mdd^Xm, Mdd^Xm, Mdd^Xm, Hd, Hd, Rr, Rr, Gs^Ft, Gs^Ft, Wwt, Gs^Ft, Gs^Ft, Rr, Rr, Ds, Ch, Rr, Rr, Mdd^Xm, Ds, Ds, Hd, Ds, Hd, Ds, Ds, Cd, Rd, Ds, Gd, Gd, Gd, Gd, Rd, Ds, Dd^Ft, Dd^Ft, Gs^Ft, Ds^Edpp, Ds, Ds, Mdd^Xm, Mdd^Xm
Ds, Ds, Ds, Ce, 1 Ke, Ce, Ds, Ds, Ds, Ds, Ds, Ds, Dd, Dd^Es, Dd, Dd, Mdd^Xm, Mdd^Xm, Mdd^Xm, Mdd^Xm, Mdd^Xm, Hd, Rr, Rr, Gs^Ft, Gs^Ft, Wwt, Wwt, Wot, Wwt, Wwt, Gs^Ft, Gs^Ft, Rr, Rr, Ch, Rr, Mdd^Xm, Ds, Ds, Hd, Hd, Hd, Ds, Ds, Cd, Rd, Ds, Gd, Gs^Vht, Gd, Ds^Edpp, Ds, Gs^Ft, Gs^Ft, Gs^Ft, Gs^Ft, Dd^Ft, Ds, Mdd, Mdd^Xm, Mdd^Xm
Ds, Ds, Ds, Ce, Ce, Ce, Ds, Ds, Ds, Dd, Dd, Dd, Dd, Dd, Ds, Ds^Edp, Mdd^Xm, Mdd^Xm, Mdd^Xm, Mdd^Xm, Mdd^Xm, Hd, Rr, Gs^Ft, Gs^Ft, Wwt, Wwt, Wot, Wwt, Wwt, Gs^Ft, Gs^Ft, Rr, Rr, Ds^Edpp, Ch, Ch, Mdd^Xm, Ds, Ds, Hd, Hd, Hd, Ds, Ds, Cd, Ds, Rd, Rd, Gd, Ds, Ds, Dd^Ft, Ds, Ds, Dd^Ft, Ds, Ds, Mdd^Xm, Mdd^Xm, Mdd^Xm, Mdd^Xm
Ds, Ds, Ds, Ds, Ds, Ds, Dd, Dd, Dd, Dd, Dd, Ds, Ds, Dd, Ds, Mdd^Xm, Mdd^Xm, Mdd^Xm, Ds, Ds, Cdr, Cdr, Cdr, Rr, Gs^Ft, Wwt, Gs^Ft, Wwt, Gs^Ft, Gs^Ft, Gs^Ft, Gs^Ft, Rr, Dd, Dd, Dd, Dd, Mdd^Xm, Mdd^Xm, Ds, Ds, Hd, Hd, Ds, Ds, Ds, Gd, Ds^Edpp, Ds, Ds, Gs, Gs^Ft, Wwt, Re, 5 Dd^Vda, Ds, Rd, Cv^Esd, Cv^Esd, Mdd^Xm, Mdd^Xm, Mdd^Xm
Ds, Ds, Ds, Ds, Ds, Ds, Ds, Dd^Dc, Dd^Es, Dd, Dd, Ds, Ds, Dd, Ds, Mdd^Xm, Mdd^Xm, Mdd^Xm, Ds, Ds, Cdr, 7 Kdr, Cdr, Rr, Rr, Gs^Ft, Rr, Gs^Ft, Rr, Rr, Rr, Rr, Dd^Edpp, Dd, Ds, Dd^Vda, Ds, Ds^Edpp, Mdd^Xm, Ds, Dd, Ds, Ds, Ds, Ds, Gd, Gd, Gd, Ds, Gs^Ft, Wwt, Wwt, Wwt, Gs^Ft, Ds, Ds, Cv^Esd, Cv^Esd, Kv, Mdd^Xm, Mdd^Xm, Mdd^Xm
Ds, Ds, Ds, Ds, Ce, Ds, Ds, Dd, Dd, Dd, Dd, Ds, Ds, Ds, Ds, Mdd^Xm, Mdd^Xm, Mdd^Xm, Ds, Ds, Ds, Cdr, Mdd^Xm, Hd, Hd, Rr, Hd, Rr, Ds^Edpp, Dd, Dd, Dd, Dd, Dd, Mdd^Xm, Ds, Mdd^Xm, Mdd^Xm, Mdd^Xm, Dd, Dd, Dd, Dd, Ds, Ds, Gd, Rr^Vd, Gd, Ds, Wwr, Wwt, Wwt, Wwr, Gs^Ft, Rd, Ds, Rd, Cv^Esd, Mdd^Xm, Mdd^Xm, Mdd^Xm, Mdd^Xm
Mdd, Ds, Ds, Ce, 2 Ke, Ce, Ds, Dd, Dd, Dd^Es, Dd, Ds, Ds, Hd, Hd, Mdd^Xm, Mdd^Xm, Mdd^Xm, Mdd^Xm, Ds, Ds, Ds, Mdd^Xm, Mdd^Xm, Mdd^Xm, Dd^Vdt, Hd, Ds, Mdd^Xm, Dd, Dd, Dd^Edpp, Mdd^Xm, Mdd^Xm, Mdd^Xm, Mdd^Xm, Ds^Edp, Mdd^Xm, Ds, Ds, Dd, Dd^Es, Dd, Ds, Ds, Gd, Gd, Gd, Ds, Dd^Ft, Gs^Ft, Gs^Ft, Ds, Ds, Ds, Rd, Ds, Cv^Esd, Mdd^Xm, Mdd^Xm, Mdd^Xm, Mdd^Xm
Mdd^Xm, Mdd^Xm, Mdd, Ce, Ce, Ce, Ds, Ds, Ds, Dd, Dd, Ds, Ds, Hd, Hd, Hd, Hd, Mdd^Xm, Mdd^Xm, Mdd^Xm, Mdd^Xm, Ds, Mdd^Xm, Mdd^Xm, Mdd^Xm, Hd, Mdd^Xm, Mdd^Xm, Mdd^Xm, Mdd^Xm, Mdd^Xm, Mdd^Xm, Mdd^Xm, Mdd^Xm, Dd, Dd, Dd^Dc, Dd, Dd, Ds, Dd, Dd, Dd, Ds, Ds, Gd, Ds, Ds, Rd, Ds, Ds, Ds, Ds, Dd^Vdt, Gs^Ft, Gs^Ft, Wwt, Ds^Edpp, Mdd, Mdd^Xm, Mdd^Xm, Mdd^Xm
Mdd^Xm, Mdd^Xm, Mdd^Xm, Ds, Ds, Ds, Ds, Ds, Ds, Ds, Ds, Ds^Edp, Ds, Ds, Hd, Hd, Ds, Mdd^Xm, Mdd^Xm, Mdd^Xm, Mdd^Xm, Mdd^Xm, Mdd^Xm, Mdd^Xm, Mdd^Xm, Mdd^Xm, Mdd^Xm, Mdd^Xm, Mdd^Xm, Mdd^Xm, Mdd^Xm, Mdd^Xm, Dd, Ds, Dd, Dd^Es, Dd, Dd, Ds, Ds, Dd^Do, Ds, Ds, Ds, Ds, Cd, Ds^Edpp, Rd, Rd, Ds^Edpp, Gd, Ds, Rd, Ds^Edpp, Dd^Ft, Wwt, Wot, Wwt, Wwt, Mdd, Mdd^Xm, Mdd^Xm
Mdd^Xm, Mdd^Xm, Mdd^Xm, Mdd, Ds, Ds, Ds, Hd, Hd, Ds, Ds, Dd, Ds, Ds, Ds, Ds, Dd, Mdd^Xm, Mdd^Xm, Mdd^Xm, Mdd^Xm, Mdd^Xm, Ds, Mdd^Xm, Ds, Mdd^Xm, Dd, Mdd^Xm, Dd, Dd, Dd, Dd, Dd, Ds, Ds, Dd, Ds, Ds, Ds, Ds, Ds, Ds, Ds, Ds, Ds, Cd, Rd, Rd, Ds, Ds, Gd, Ds^Edpp, Ds, Rd, Gs^Ft, Wwt, Wot, Wot, Wwt, Wwr, Mdd^Xm, Mdd^Xm
Mdd^Xm, Mdd^Xm, Mdd^Xm, Mdd^Xm, Mdd^Xm, Ds, Ds, Ds, Hd, Ds, Ds, Dd, Dd, Ds, Ds, Dd, Dd^Es, Dd, Dd, Ds, Hd, Ds, Ds, Ds, Dd^Edp, Dd, Dd, Dd, Dd, Dd^Es, Dd, Dd^Vdt, Ds, Ds, Ds, Ds, Ds, Ds, Hd, Hd, Hd, Hd, Ds, Ds, Ds, Cd, Cd, Ds^Edpp, Gd, Gd, Gd, Gd, Ds, Rd, Gs^Ft, Wwt, Wwt, Wwt, Gs^Ft, Gs^Ft, Gs^Ft, Mdd^Xm
Mdd^Xm, Mdd^Xm, Mdd^Xm, Mdd^Xm, Mdd^Xm, Mdd, Ds, Ds, Hd, Hd, Ds, Ds, Ds, Dd, Dd^Dc, Dd, Dd, Dd, Ds, Ds, Hd, Hd, Ds, Ds, Ds, Dd, Ds, Dd, Ds, Dd, Ds, Ds, Cte, Cte, Wwt, Ds, Ds, Ds, Ds, Hd, Hd, Hd, Ds, Ds, Ds, Ds, Ds, Cd, Gd, Gs^Vht, Gd, Gd, Cd, Rd, Cd, Wwf^Vhs, Gs^Ft, Dd^Ft, Dd^Ft, Dd^Ft, Ds^Edpp, Mdd^Xm
Mdd^Xm, Mdd^Xm, Mdd^Xm, Mdd^Xm, Mdd^Xm, Mdd^Xm, Mdd, Ds, Ds, Hd, Hd, Ds, Dd^Do, Dd^Edp, Dd, Dd^Es, Dd, Dd, Ds, Ds, Hd, Hd, Hd, Ds, Hd, Ds, Ds, Dd^Fi|, Ds, Ds, Cte, Cte, Wwt, Wwt, Wwt, Gd^Ft, Ds, Dd^Vda, Ds, Ds, Ds, Hd, Hd, Ds, Dd, Ds, Dd, Ds, Ds, Ds, Ds, Cd, Ds, Cd, Ds, Cd, Dd, Dd^Ft, Dd, Ds, Mdd^Xm, Mdd^Xm
Mdd^Xm, Mdd^Xm, Mdd^Xm, Mdd^Xm, Mdd^Xm, Mdd^Xm, Mdd^Xm, Ds, Ds, Ds, Ds, Ds, Ds, Dd, Dd^Es, Dd, Ds, Ds, Ds, Ds, Hd, Hd, Hd, Hd, Hd, Ds, Ds, Ds, Ds, Ds, Cte, 4 Kte, Wwt, Wot, Wwt, Gd^Ft, Ds, Ds, Dd, Dd, Ds, Hd, Ds, Ds, Dd, Dd, Dd^Es, Dd, Dd, Ds, Ds, Ds, Ds, Ds, Ds, Ds, Dd^Dc, Dd, Ds, Ds^Edp, Mdd^Xm, Mdd^Xm
Mdd^Xm, Mdd^Xm, Mdd^Xm, Mdd^Xm, Mdd^Xm, Mdd^Xm, Ds^Edp, Ds, Ds, Ds, Ds, Ds, Ds, Dd, Dd, Dd, Ds, Ds, Ds, Ds, Ds, Ds, Ds, Ds, Ds, Ds, Ds, Ds, Ds, Ds, Cte, Gd^Ft, Wwt, Wwt, Gd^Ft, Gd^Ft, Dd^Dc, Dd, Dd^Edpp, Dd, Ds, Ds, Ds, Ds, Ds, Dd, Dd, Dd^Dc, Dd, Ds, Ds, Ds, Ds, Ds, Ds, Dd, Ds, Dd, Ds, Mdd, Mdd^Xm, Mdd^Xm
Mdd^Xm, Mdd^Xm, Mdd^Xm, Mdd^Xm, Mdd^Xm, Mdd^Xm, Mdd, Ds, Ds, Ds^Es, Ds, Ds, Ds, Ds, Ds, Ds, Ds, Mdd, Mdd^Xm, Ds, Ds, Ds, Ds, Ds, Ds^Es, Ds, Ds, Dd^Vdt, Ds, Ds, Ds, Gd^Ft, Gd^Ft, Gd^Ft, Ds, Gd^Ft, Ds, Dd, Dd, Dd, Ds, Ds, Mdd^Xm, Mdd, Ds, Ds, Ds, Dd, Ds, Ds, Hd, Ds, Hd, Hd, Hd, Ds, Ds, Ds, Mdd^Xm, Mdd^Xm, Mdd^Xm, Mdd^Xm
Mdd^Xm, Mdd^Xm, Mdd^Xm, Mdd^Xm, Mdd^Xm, Mdd^Xm, Mdd^Xm, Ds, Ds^Edp, Ds, Ds, Ds, Mdd^Xm, Ds, Mdd^Xm, Mdd^Xm, Mdd^Xm, Mdd^Xm, Mdd^Xm, Mdd^Xm, Mdd^Xm, Mdd, Mdd^Xm, Ds, Ds, Ds, Ds, Ds, Ds, Ds, Mdd^Xm, Ds, Mdd, Ds, Mdd^Xm, Ds, Ds, Ds, Ds, Ds, Ds, Ds, Mdd^Xm, Mdd^Xm, Mdd^Xm, Ds, Mdd^Xm, Ds, Ds, Ds, Ds^Es, Hd, Hd, Hd, Ds, Ds, Ds, Mdd, Mdd^Xm, Mdd^Xm, Mdd^Xm, Mdd^Xm
Mdd^Xm, Mdd^Xm, Mdd^Xm, Mdd^Xm, Mdd^Xm, Mdd^Xm, Mdd^Xm, Mdd^Xm, Mdd^Xm, Mdd^Xm, Mdd^Xm, Mdd^Xm, Mdd^Xm, Mdd^Xm, Mdd^Xm, Mdd^Xm, Mdd^Xm, Mdd^Xm, Mdd^Xm, Mdd^Xm, Mdd^Xm, Mdd^Xm, Mdd^Xm, Mdd^Xm, Mdd^Xm, Mdd^Xm, Mdd^Xm, Mdd^Xm, Mdd^Xm, Mdd^Xm, Mdd^Xm, Mdd^Xm, Mdd^Xm, Mdd^Xm, Mdd^Xm, Mdd^Xm, Mdd^Xm, Mdd^Xm, Mdd^Xm, Mdd^Xm, Mdd^Xm, Mdd^Xm, Mdd^Xm, Mdd^Xm, Mdd^Xm, Mdd^Xm, Mdd^Xm, Mdd^Xm, Mdd^Xm, Mdd^Xm, Mdd^Xm, Mdd^Xm, Mdd^Xm, Mdd^Xm, Mdd^Xm, Mdd^Xm, Mdd^Xm, Mdd^Xm, Mdd^Xm, Mdd^Xm, Mdd^Xm, Mdd^Xm
