border_size=1
usage=map

Xu          , Xu          , Xu          , Xu          , Xu          , Xu          , Xu          , Xu          , Xu          , Xu          , Xu          , Xu          , Xu          , Xu          , Xu          , Xu          , Xu          , Xu          , Xu          , Xu          , Xu          , Xu          , Xu          , Xu          , Xu          , Xu          , Xu          , Xu          , Xu          , Xu          , Xu          , Xu          , Xu          , Xu          , Xu          , Xu          , Xu          , Xu          , Xu          , Xu          , Xu          , Xu          , Xu          , Xu          , Xu          , Xu          , Xu          , Wo          , Wo          , Wo          , Xu          , Xu          , Xu          , Xu          , Xu          , Xu          , Xu          , Xu          , Xu          
Xu          , Xu          , Ww          , Ww          , Ss          , Ww          , Ss          , Xu          , Ss^Vm       , Xu          , Xu          , Xu          , Xu          , Xu          , Uu^Vud      , Uh          , Uu          , Uu^Uf       , Rd          , Uu^Uf       , Uh          , Uh          , Uh          , Uh          , Uh          , Xu          , Uh          , Xu          , Uh          , Xu          , Xu          , Xu          , Uu          , Xu          , Uu          , Uu^Vud      , Uu          , Uu          , Uu          , Uu          , Uu          , Xu          , Xu          , Xu          , Uu^Vud      , Xu          , Xu          , Wo          , Wo          , Wo          , Xu          , Xu          , Xu          , Xu          , Cud         , Xu          , 4 Kud       , Xu          , Xu          
Xu          , Xu          , Ss          , Ss          , Xu          , Ss          , Ww          , Ss          , Ss          , Ss          , Ss          , Xu          , Uu^Uf       , Uh          , Uu          , Uu          , Rd          , Rd          , Uu          , Rd          , Uu          , Uu          , Uh          , Rd          , Rd          , Rd          , Rd          , Uu^Uf       , Uu          , Uu          , Uu          , Uu          , Uu          , Uu          , Uu          , Uu          , Uh          , Uh          , Uh          , Uh          , Uu          , Uu          , Xu          , Uu          , Uu          , Uu          , Uu          , Wo          , Wo          , Wo          , Uu^Uf       , Xu          , Cud         , Cud         , Cud         , Cud         , Cud         , Xu          , Xu          
Rd          , Rd          , Ss          , Ss          , Xu          , Ww          , Ww          , Ss          , Ss          , Ss          , Rd          , Uu          , Uu          , Uh          , Uh          , Uu          , Xu          , Xu          , Xu          , Uu          , Uu          , Uu          , Uu          , Uu          , Uu          , Uu          , Uu          , Uu          , Uh          , Uh          , Uh          , Uu          , Xu          , Uu          , Uu          , Uu          , Uu          , Uu          , Xu          , Uu          , Uu          , Uu          , Xu          , Uu          , Uu          , Uu          , Uu          , Wo          , Wo          , Wo          , Rd          , Rd          , Rd          , Cud         , Uu          , Cud         , Uh          , Cud         , Xu          
Uu          , Rd          , Ss          , Xu          , Chw         , Chw         , Chw         , Ss          , Ss          , Xu          , Rd          , Rd          , Xu          , Xu          , Xu          , Xu          , Uu^Uf       , Uu^Uf       , Rd          , Rd          , Rd          , Uu^Uf       , Xu          , Xu          , Uu          , Uu          , Rd          , Uu          , Uu          , Uh          , Uh          , Uu          , Xu          , Xu          , Xu          , Uu          , Xu          , Xu          , Uu^Vud      , Rd          , Rd          , Xu          , Xu          , Uu          , Uh          , Uu          , Wo          , Wo          , Wo^Bw/      , Uu          , Uu^Uf       , Rd          , Uu          , Uu          , Uu^Vud      , Uu          , Uh          , Uh          , Xu          
Uu          , Ss          , Ss          , Xu          , Xu          , Chw         , 5 Khw       , Chw         , Xu          , Xu          , Rd          , Uh          , Uh          , Uu          , Uu          , Rd          , Rd          , Uu^Uf       , Rd          , Rd          , Xu          , Xu          , Uh          , Uh          , Uu          , Rd          , Uu          , Uu^Uf       , Uu          , Rd          , Rd          , Uu          , Uu          , Uu          , Uu          , Xu          , Uu          , Xu          , Uu          , Rd          , Rd          , Xu          , Xu          , Uu          , Uh          , Uh          , Wo^Bw/      , Wo^Bw/      , Wo          , Wo          , Uu          , Uu          , Uu          , Uu          , Uu          , Uu          , Uh          , Uh          , Xu          
Uu          , Uu          , Ss          , Ss^Vhs      , Ss          , Xu          , Xu          , Xu          , Uu^Vud      , Uu          , Uu          , Uh          , Uh          , Uu          , Uu          , Uu          , Uh          , Rd          , Uu          , Uu          , Uh          , Uh          , Rd          , Uh          , Uu^Uf       , Rd          , Uh          , Uh          , Xu          , Xu          , Xu          , Rd          , Uu          , Uh          , Uh          , Uu          , Xu          , Xu          , Uu          , Rd          , Uu          , Uu          , Rd          , Uh          , Rd          , Uu          , Uu          , Wo          , Wo          , Wo          , Xu          , Xu          , Xu          , Uu^Uf       , Xu          , Uu          , Uu          , Uu^Uf       , Xu          
Uu          , Uu          , Ss          , Ss          , Ss          , Ss          , Ss          , Uu          , Uu          , Uu^Uf       , Uh          , Xu          , Xu          , Xu          , Xu          , Xu          , Xu          , Xu          , Uu^Uf       , Uu          , Uh          , Rd          , Uh          , Uu^Vud      , Uh          , Uh          , Uh          , Uh          , Xu          , Xu          , Uh          , Xu          , Xu          , Rd          , Rd          , Uu          , Xu          , Uu          , Rd          , Rd          , Uh          , Uu          , Rd          , Rd          , Uu          , Uu          , Uu          , Wo          , Wo          , Wo          , Uu          , Uu^Vu       , Uu          , Xu          , Uu          , Uu          , Uu          , Uu^Uf       , Xu          
Wwf         , Ss          , Wwf         , Ss          , Ss          , Ss          , Ss          , Uu          , Uh          , Uu^Uf       , Uh          , Uh          , Uh          , Uu^Uf       , Rd          , Uu          , Rd          , Rd          , Rd          , Rd          , Uu          , Uu          , Uu          , Xu          , Xu          , Xu          , Xu          , Xu          , Uu^Vud      , Uu^Uf       , Uh          , Uh          , Xu          , Uu          , Uu          , Rd          , Rd          , Rd          , Rd          , Uh          , Uu          , Xu          , Uu          , Uu          , Uu          , Uu          , Wo          , Wo^Bw\      , Wo^Bw\      , Wo          , Uu^Uf       , Uu          , Uu          , Rd          , Rd          , Rd          , Rd          , Uu          , Xu          
Wwf         , Wwf         , Ww          , Ww          , Ww          , Ss          , Ss          , Ss          , Uh          , Uh          , Xu          , Uh          , Uh          , Rd          , Uu^Vud      , Rd          , Uu^Uf       , Rd          , Xu          , Uu          , Xu          , Uu          , Xu          , Xu          , Uh          , Uh          , Uu^Uf       , Uu          , Cud         , Uu^Uf       , Uu          , Uh          , Xu          , Xu          , Uu          , Uu          , Uu          , Rd          , Uu          , Uh          , Uu          , Xu          , Xu          , Xu          , Xu          , Xu          , Wo          , Wo          , Uu          , Uu          , Uu          , Uu          , Uu          , Rd          , Uu          , Rd          , Uu^Uf       , Xu          , Xu          
Wwf         , Wwf         , Wwf         , Ww          , Ww          , Ww          , Ss          , Ss          , Xu          , Xu          , Mm^Xm       , Xu          , Xu          , Xu          , Xu          , Xu          , Xu          , Xu          , Xu          , Xu          , Xu          , Xu          , Xu          , Uh          , Uh          , Uh          , Uu          , Cud         , Kud         , Cud         , Uu          , Uu          , Uu^Uf       , Xu          , Uu          , Uu          , Uu          , Uu          , Uu          , Uu          , Xu          , Xu          , Uu          , Uu          , Uu          , Wo          , Wo          , Wo          , Uu          , Uu          , Uu^Uf       , Xu          , Uu          , Uu          , Uu          , Uu          , Xu          , Xu          , Gg          
Wwf         , Wwf         , Ww          , Ww          , Ww          , Ww          , Ww          , Ss          , Ss          , Mm^Xm       , Mm^Xm       , Mm^Xm       , Mm^Xm       , Xu          , Mm^Xm       , Xu          , Mm^Xm       , Xu          , Xu          , Xu          , Xu          , Xu          , Xu          , Uh          , Uu^Uf       , Uu^Vud      , Uu          , Cud         , Cud         , Cud         , Uu          , Uu          , Uu          , Xu          , Xu          , Xu          , Xu          , Uu          , Uu          , Uu          , Xu          , Xu          , Rd          , Rd          , Uu          , Wo          , Wo^Bw/      , Uu          , Uh          , Uu^Uf       , Xu          , Xu          , Uu          , Rd          , Rd          , Xu          , Xu          , Gg          , Gs^Fp       
Wwf         , Wwf         , Ww          , Ww          , Ww          , Ww          , Ww          , Ss^Vm       , Ss          , Gg^Efm         , Gg^Efm         , Mm^Xm       , Mm^Xm       , Mm^Xm       , Mm^Xm       , Mm^Xm       , Mm^Xm       , Mm^Xm       , Mm^Xm       , Mm^Xm       , Mm^Xm       , Xu          , Mm^Xm       , Xu          , Xu          , Uu^Uf       , Uu          , Cud         , Uu          , Uu          , Uu          , Uh          , Uu^Vud      , Uu^Uf       , Uh          , Uh          , Uh          , Xu          , Uu          , Uu          , Uu          , Uu          , Rd          , Rd          , Uu^Vu       , Wo^Bw/      , Wo          , Uh          , Uh          , Uh          , Xu          , Uu          , Rd          , Rd          , Rd          , Xu          , Gg          , Gs^Fp       , Gs^Fp       
Wwf         , Wwf         , Wwf         , Ww          , Ww          , Ww          , Ww          , Ss          , Ss          , Gg          , Gg^Fet      , Mm          , Mm          , Mm          , Mm          , Mm          , Mm          , Mm          , Ha^Vhha     , Mm^Xm       , Mm          , Mm^Xm       , Mm          , Mm^Xm       , Mm^Xm       , Xu          , Xu          , Uu          , Uu^Uf       , Uu^Uf       , Uu          , Uh          , Uh          , Uu          , Uu          , Uh          , Uu^Uf       , Xu          , Xu          , Uu          , Uu          , Uu          , Uu          , Uu          , Wo          , Wo          , Wo          , Uh          , Xu          , Xu          , Xu          , Rd          , Gg          , Gg^Efm         , Gg^Efm         , Gs^Fp       , Gs^Fp       , Gs^Fp       , Gs^Fp       
Wwf         , Wwf         , Wwf         , Ww          , Ww          , Ww          , Ww          , Ss          , Ss          , Ss          , Gg^Efm         , Mm          , Mm          , Mm          , Hh^Vhh      , Mm          , Gg          , Mm          , Mm          , Mm          , Mm          , Mm          , Mm          , Mm          , Mm^Xm       , Mm^Xm       , Xu          , Xu          , Uu^Uf       , Uu          , Uu^Vud      , Uu          , Uu^Uf       , Uu          , Uu          , Uu          , Uu          , Uu          , Mm^Xm       , Mm^Xm       , Mm^Xm       , Mm^Xm       , Mm^Xm       , Mm^Xm       , Wo          , Wo          , Mm^Xm       , Mm^Xm       , Mm^Xm       , Mm^Xm       , Mm^Xm       , Gg          , Gg          , Gg^Efm         , Gg          , Gg          , Gg          , Gs^Fp       , Gg          
Wwf         , Wwf         , Ww          , Ww          , Ww          , Ww          , Ss^Vhs      , Ss          , Ss          , Ss          , Gg          , Mm          , Mm          , Mm          , Mm          , Mm          , Mm          , Mm          , Mm          , Mm          , Mm          , Mm          , Mm          , Mm          , Gg          , Mm^Xm       , Mm^Xm       , Xu          , Xu          , Xu          , Xu          , Xu          , Xu          , Uu^Uf       , Uu          , Uu          , Uu          , Uu          , Mm^Xm       , Gg          , Gg          , Gg^Efm         , Ww          , Mm^Xm       , Ww          , Wo          , Mm^Xm       , Mm^Xm       , Ch          , Ch          , Ch          , Ch          , Ch          , Ch          , Ch          , Ch          , Ch          , Ch          , Ch          
Wwf         , Wwf         , Ww          , Ww          , Wwf         , Ww          , Wwf         , Wwf         , Gg^Fet      , Gg          , Hh^Vhh      , Mm          , Mm          , Mm          , Mm          , Mm          , Mm          , Mm          , Mm          , Mm          , Mm          , Mm          , Gg          , Mm          , Gg          , Gg          , Gg          , Mm^Xm       , Mm^Xm       , Mm^Xm       , Mm^Xm       , Mm^Xm       , Mm^Xm       , Xu          , Mm^Xm       , Uu          , Mm^Xm       , Mm^Xm       , Gg          , Gg          , Gg^Efm         , Gg^Efm         , Ww          , Ww          , Ww          , Ww          , Rd          , Rd          , Rd          , Rd          , Rd          , Gg          , Rd          , Gg          , Rd          , Gg          , Rd          , Gg          , Gg          
Wwf         , Wwf         , Wwf         , Wwf         , Wwf         , Wwf         , Wwf         , Wwf         , Gg^Efm         , Gg^Efm         , Mm^Xm       , Mm          , Mm^Xm       , Mm^Xm       , Mm^Xm       , Mm          , Mm          , Mm          , Mm          , Mm          , Mm          , Mm          , Mm          , Mm          , Gg          , Gg          , Gs^Fdf      , Gg          , Gg          , Gg          , Gg          , Gg          , Gg          , Mm^Xm       , Gg          , Mm^Xm       , Gs^Fds      , Gs^Fds      , Gs^Fds      , Gg^Fet      , Gg^Efm         , Gg          , Ww          , Ww          , Ww^Bw/      , Ww^Bw/      , Gg          , Rd          , Gg          , Rd          , Gg^Vh       , Rd          , Gg          , Rd          , Gg          , Rd          , Gg^Fet      , Rd          , Rd          
Wwf         , Wwf         , Wwf         , Wwf         , Mm^Xm       , Mm^Xm       , Mm^Xm       , Mm^Xm       , Mm^Xm       , Mm^Xm       , Mm^Xm       , Mm^Xm       , Gs^Fp       , Mm^Xm       , Mm^Xm       , Mm^Xm       , Mm^Xm       , Hh^Vhh      , Mm          , Mm          , Mm          , Mm          , Gg          , Gg          , Gs^Fdf      , Gs^Fdf      , Gg          , Gg          , Gg          , Gg          , Gg          , Gg          , Gg^Fet      , Gg^Efm         , Gg          , Gs^Fds      , Gs^Fds      , Gs^Fds      , Gs^Fds      , Gg^Ve       , Gg          , Gg          , Ww^Bw/      , Ww^Bw/      , Ww          , Ww          , Gg          , Ch          , Gg          , Gg          , Gg^Efm         , Gg^Efm         , Ch          , Ch          , Ch          , Gg          , Gg          , Gg^Ve       , Gg          
Mm^Xm       , Mm^Xm       , Mm^Xm       , Mm^Xm       , Mm^Xm       , Mm^Xm       , Mm^Xm       , Mm^Xm       , Mm^Xm       , Mm^Xm       , Gs^Fp       , Gs^Fp       , Gs^Fp       , Gs^Fp       , Gg          , Mm^Xm       , Mm^Xm       , Mm          , Mm          , Mm          , Gg          , Gg          , Gg          , Gs^Fdf      , Gs^Fdf      , Gs^Fdf      , Gs^Fdf      , Gs^Fdf      , Gg^Fet      , Gg          , Gs^Fdf      , Gg          , Gg          , Gg          , Gs^Fds      , Gs^Fds      , Gs^Fds      , Gs^Fds      , Rd          , Gg          , Rd          , Rd          , Ww          , Ww          , Ww          , Ww          , Gg          , Ch          , Gg          , Gg^Fet      , Gg          , Gg          , Ch          , Ch          , Ch          , Ch          , Gg          , Gg^Efm         , Gg          
Mm^Xm       , Mm^Xm       , Mm^Xm       , Mm^Xm       , Mm^Xm       , Mm^Xm       , Mm^Xm       , Mm^Xm       , Mm^Xm       , Mm^Xm       , Gs^Fp       , Gs^Fp       , Gs^Fp       , Gs^Fp       , Gs^Fp       , Gg          , Mm^Xm       , Mm^Xm       , Mm^Xm       , Mm^Xm       , Gg          , Gg          , Gg          , Gs^Fdf      , Gg          , Gg          , Gg          , Gs^Fdf      , Gs^Fdf      , Gs^Fdf      , Gs^Fdf      , Gs^Fdf      , Gs^Fdf      , Gg          , Gg          , Gg          , Rd          , Gg          , Rd          , Rd          , Rd          , Ww          , Ww          , Ww          , Ww          , Ww          , Gg^Fet      , Ch          , Gg          , Gg          , Gg^Efm         , Gg          , Ch          , Ch          , 3 Kh        , Ch          , Gg          , Gg          , Gg          
Mm^Xm       , Mm^Xm       , Mm^Xm       , Mm^Xm       , Mm^Xm       , Mm^Xm       , Gs^Fp       , Gg          , Gg^Fet      , Gs^Fp       , Gs^Fp       , Gg          , Gs^Fp       , Gs^Fp       , Gs^Fp       , Gs^Fp       , Gg^Efm         , Gg          , Gs^Fp       , Gg          , Gs^Fp       , Gs^Fp       , Gs^Fp       , Gg          , Gg^Efm         , Gg^Fet      , Gg          , Gs^Fdf      , Gs^Fdf      , Gg^Ve       , Gs^Fdf      , Gs^Fdf      , Gg          , Gg^Efm         , Rd          , Rd          , Gg^Efm         , Rd          , Gs^Fp       , Gg          , Ww          , Ww^Bw\      , Ww^Bw\      , Ww          , Ww          , Ww          , Gg          , Ch          , Gg          , Gg^Efm         , Gg          , Gg          , Ch          , Ch          , Ch          , Ch          , Gg          , Gg^Fet      , Gg          
Mm^Xm       , Mm^Xm       , Mm^Xm       , Mm^Xm       , Gg^Efm         , Gg          , Gs^Fp       , Gs^Fp       , Gs^Fp       , Gg          , Gs^Fp       , Gg^Fet      , Gs^Fp       , Gs^Fp       , Gs^Fp       , Gs^Fp       , Gs^Fp       , Gg          , Gs^Fp       , Gs^Fp       , Gg          , Gs^Fp       , Gg          , Gg^Efm         , Gg          , Gg          , Gg          , Gs^Fdf      , Gs^Fdf      , Gs^Fdf      , Gs^Fdf      , Gs^Fdf      , Gg^Fet      , Gg          , Rd          , Rd          , Rd          , Gg^Fet      , Gs^Fp       , Gs^Fp       , Ww          , Ww          , Ww          , Rd          , Ww^Bw\      , Ww          , Ww          , Ch          , Gg          , Gg          , Gg^Fet      , Gg          , Gg          , Ch          , Ch          , Ch          , Gg          , Gg          , Gg          
Mm^Xm       , Mm^Xm       , Gg          , Gg          , Ce          , Gg          , Gg          , Gs^Fp       , Gs^Fp       , Gs^Fp       , Gs^Fp       , Gs^Fp       , Gs^Fp       , Gs^Fp       , Gs^Fp       , Gs^Fp       , Gs^Fp       , Gg^Fet      , Gs^Fp       , Gs^Fp       , Gg^Fet      , Gg          , Gg^Efm         , Gg          , Gs^Fdw      , Gs^Fdw      , Gg          , Gg^Efm         , Gg          , Gg          , Rd          , Rd          , Rd          , Rd          , Gg          , Rd          , Rd          , Rd          , Rd          , Ww          , Ww          , Ww          , Gs^Fms      , Gg          , Gg          , Ww^Bw\      , Ww^Bw\      , Ch          , Gg^Efm         , Gg          , Gg          , Gg          , Gg^Efm         , Gg          , Gg          , Ch          , Rd          , Gg^Efm         , Rd          
Mm^Xm       , Mm^Xm       , Gg          , Ce          , 2 Ke        , Ce          , Gg          , Gs^Fp       , Gs^Fp       , Gs^Fp       , Gs^Fp       , Gg^Fet      , Gs^Fp       , Gs^Fp       , Gg^Fet      , Gs^Fp       , Gs^Fp       , Gs^Fp       , Gg          , Gs^Fp       , Gs^Fp       , Gg          , Gg          , Gg          , Gs^Fdw      , Gg          , Gg^Fet      , Gg          , Rd          , Rd          , Gg          , Rd          , Gg          , Gg^Efm         , Gs^Fp       , Gg          , Gs^Fp       , Gs^Fp       , Ww          , Ww^Bw\      , Ww^Bw\      , Ww          , Gs^Fms      , Gs^Fms      , Gg^Ve       , Ww          , Ww          , Rd          , Rd          , Gg^Ve       , Rd          , Gg^Efm         , Rd          , Rd          , Rd          , Rd          , Gg^Efm         , Rd          , Gg          
Gg          , Gg          , Gg^Efm         , Ce          , Ce          , Ce          , Gg          , Gs^Fp       , Gs^Fp       , Gs^Fp       , Gs^Fp       , Gs^Fp       , Gs^Fp       , Gs^Fp       , Gs^Fp       , Gs^Fp       , Gs^Fp       , Gs^Fp       , Gg          , Gs^Fp       , Gs^Fp       , Gs^Fp       , Gs^Fp       , Gg          , Gs^Fdw      , Gs^Fdw      , Rd          , Rd          , Gs^Fdw      , Gg          , Gs^Fdw      , Gg          , Gg          , Gg^Efm         , Gg          , Gs^Fp       , Gs^Fp       , Gs^Fp       , Ww          , Ww          , Ww          , Rd          , Gs^Fms      , Gs^Fms      , Gg          , Ww          , Ww          , Ch          , Rd          , Rd          , Rd          , Rd          , Gg^Fet      , Gg^Wm       , Gg          , Gg          , Gg^Efm         , Gg          , Gg          
Gg          , Gg          , Gg^Efm         , Gg          , Gg          , Gg          , Gg          , Gs^Fp       , Gs^Fp       , Gs^Fp       , Gs^Fp       , Gs^Fp       , Gg^Efm         , Gs^Fp       , Gs^Fp       , Gs^Fp       , Gs^Fp       , Gs^Fp       , Gg^Fet      , Gg          , Gs^Fp       , Gs^Fp       , Gs^Fp       , Gg          , Rd          , Rd          , Gg^Efm         , Gs^Fdw      , Gs^Fdw      , Gs^Fdw      , Gg          , Gg^Efm         , Gg          , Gg^Fet      , Mm^Xm       , Mm^Xm       , Mm^Xm       , Gg          , Mm^Xm       , Ww          , Ww          , Rd          , Rd          , Gs^Fms      , Ww          , Ww          , Ww^Bw/      , Rd          , Gg          , Gg          , Gg^Efm         , Gg          , Gg^Efm         , Gg          , Gg          , Gg^Fet      , Gg          , Gg          , Gg          
Gg          , Gg^Fet      , Gg          , Gg^Efm         , Gg          , Gg^Fet      , Gg          , Gs^Fp       , Gs^Fp       , Gg          , Gs^Fp       , Gg^Fet      , Gg          , Gg          , Gs^Fp       , Gg^Fet      , Gs^Fp       , Gg          , Gg          , Gg^Efm         , Gg^Efm         , Gs^Fp       , Gs^Fp       , Gg          , Rd          , Gg^Efm         , Gs^Fdw      , Gs^Fdw      , Gs^Fdw      , Gs^Fdw      , Gg          , Gg          , Mm^Xm       , Mm^Xm       , Uu          , Uu          , Uu          , Mm^Xm       , Xu          , Ww          , Ww          , Gg          , Rd          , Gs^Fms      , Ww^Bw/      , Ww^Bw/      , Gg          , Ch          , Gg          , Gg          , Ch          , Gg          , Ch          , Gg          , Ch          , Gg          , Ch          , Gg          , Ch          
Gg          , Gg          , Gg          , Gg          , Ce          , Gg          , Gg          , Gg          , Gg          , Gg          , Gs^Fp       , Gs^Fp       , Gg^Fet      , Gs^Fp       , Gs^Fp       , Gg^Efm         , Gs^Fp       , Gs^Fp       , Gs^Fp       , Gs^Fp       , Gs^Fp       , Gg          , Rd          , Rd          , Gg          , Gs^Fdw      , Gs^Fdw      , Gs^Fdw      , Gs^Fdw      , Gg          , Gg^Fet      , Gg          , Mm^Xm       , Uu          , Uu          , Uu          , Uu          , Uu^Uf       , Xu          , Ww          , Ww          , Ww          , Gg          , Rd          , Ww          , Ww          , Gg          , Gg          , Gg          , Ch          , Gg          , Ch          , Gg          , Ch          , Gg          , Ch          , Gg          , Ch          , Gg          
Mm^Xm       , Gg          , Gg          , Ce          , 1 Ke        , Ce          , Gg          , Gg^Fet      , Gg          , Gg^Fet      , Gs^Fp       , Gs^Fp       , Gs^Fp       , Gs^Fp       , Gs^Fp       , Gs^Fp       , Gg^Fet      , Gs^Fp       , Gs^Fp       , Gs^Fp       , Gg          , Gs^Fp       , Rd          , Gg          , Gg          , Gg          , Gs^Fdw      , Gs^Fdw      , Gs^Fdw      , Gg          , Gg          , Gg          , Mm^Xm       , Xu          , Uu^Uf       , Uu          , Uh          , Uu^Uf       , Xu          , Ww          , Ww          , Ww          , Ww          , Ww          , Ww          , Ww          , Ww          , Gg^Efm         , Gg^Fet      , Gg          , Gg          , Gg          , Gg          , Gg^Efm         , Gg^Efm         , Gg          , Gg          , Gg          , Gg          
Mm^Xm       , Gg          , Gg          , Ce          , Ce          , Ce          , Gs^Fp       , Gg          , Gs^Fp       , Gs^Fp       , Gg          , Gs^Fp       , Gs^Fp       , Gg          , Gs^Fp       , Gs^Fp       , Gs^Fp       , Gs^Fp       , Gg          , Gg          , Rd          , Rd          , Gs^Fp       , Gg          , Gg          , Gg^Fet      , Gs^Fdw      , Gs^Fdw      , Gs^Fdw      , Gg^Efm         , Gg          , Mm^Xm       , Xu          , Xu          , Uh          , Uh          , Uh          , Uu          , Uu^Uf       , Xu          , Xu          , Ww          , Ww          , Ww          , Ww          , Ww          , Ww          , Ww          , Gg          , Gg          , Gg^Ve       , Gg          , Gg          , Gg^Efm         , Gg          , Gg          , Gg^Fet      , Gg          , Gg          
Mm^Xm       , Mm^Xm       , Rd          , Gg          , Gg          , Gg          , Gg^Efm         , Gs^Fp       , Gg^Efm         , Gg^Fet      , Gg          , Gs^Fp       , Gs^Fp       , Gs^Fp       , Gs^Fp       , Gs^Fp       , Gs^Fp       , Gs^Fp       , Gg          , Gg^Fet      , Rd          , Rd          , Gs^Fp       , Gs^Fp       , Mm^Xm       , Gg          , Mm^Xm       , Gs^Fdw      , Gg          , Gg          , Mm^Xm       , Mm^Xm       , Xu          , Xu          , Uu^Uf       , Uh          , Uh          , Uu          , Uu          , Cud         , Cud         , Xu          , Xu          , Ww          , Ww          , Ww          , Ww          , Ww          , Ww          , Gg          , Gg          , Gg          , Gg          , Gg          , Gg          , Gg          , Gg^Efm         , Gg          , Gg          
Mm^Xm       , Mm^Xm       , Mm^Xm       , Rd          , Rd          , Gg          , Rd          , Gg^Efm         , Gg^Efm         , Gg          , Gg          , Gg^Fet      , Gs^Fp       , Gs^Fp       , Gs^Fp       , Gg^Fet      , Gs^Fp       , Gs^Fp       , Rd          , Rd          , Gs^Fp       , Gs^Fp       , Mm^Xm       , Mm^Xm       , Mm^Xm       , Mm^Xm       , Mm^Xm       , Gg          , Mm^Xm       , Mm^Xm       , Mm^Xm       , Mm^Xm       , Xu          , Uu^Uf       , Uu^Uf       , Uu          , Uu^Uf       , Uu          , Cud         , Cud         , Cud         , Kud         , Xu          , Xu          , Ww          , Ww          , Ww          , Ww          , Ww          , Gg          , Gg          , Gg^Efm         , Gg          , Gg^Fet      , Gg          , Gg^Efm         , Gg          , Gg          , Gg          
Mm^Xm       , Mm^Xm       , Mm^Xm       , Mm^Xm       , Mm^Xm       , Rd          , Rd          , Rd          , Rd          , Rd          , Rd          , Rd          , Rd          , Rd          , Rd          , Rd          , Rd          , Rd          , Gs^Fp       , Gs^Fp       , Gg          , Gg          , Mm^Xm       , Mm^Xm       , Mm^Xm       , Mm^Xm       , Mm^Xm       , Mm^Xm       , Mm^Xm       , Mm^Xm       , Xu          , Xu          , Xu          , Xu          , Xu          , Uu          , Xu          , Uu          , Xu          , Cud         , Xu          , Cud         , Xu          , Xu          , Xu          , Ww          , Ww          , Ww          , Ww          , Gg          , Gg^Fet      , Gg          , Gg^Efm         , Gg          , Gg          , Gg^Vh       , Gg          , Gg          , Gg          
Mm^Xm       , Mm^Xm       , Mm^Xm       , Mm^Xm       , Mm^Xm       , Gg          , Gg          , Gg^Fet      , Gg          , Gg          , Gg          , Gg          , Gg          , Gg          , Gg          , Gg          , Gg          , Gg          , Gg          , Gs^Fp       , Gg          , Gg          , Mm^Xm       , Mm^Xm       , Mm^Xm       , Mm^Xm       , Mm^Xm       , Mm^Xm       , Mm^Xm       , Mm^Xm       , Xu          , Xu          , Xu          , Xu          , Xu          , Xu          , Xu          , Xu          , Xu          , Xu          , Xu          , Xu          , Xu          , Xu          , Xu          , Ww          , Ww          , Ww          , Ww          , Ww          , Gg          , Gg          , Gg          , Gg          , Gg          , Gg          , Gg          , Gg^Fet      , Gg          
