Xu, Xu, Xu, Xu, Xu, Xu, Xu, Xu, Xu, Xu, Xu, Xu, Xu, Xu, Xu, Xu, Xu, Xu, Xu, Xu, Xu, Xu, Xu, Xu, Xu, Xu, Xu, Xu, Xu, Xu, Xu, Xu, Xu, Xu, Xu, Xu, Xu, Xu, Xu, Xu, Xu, Xu, Xu, Xu, Xu, Xu, Xu, Wog, Wog, Wog, Xu, Xu, Xu, Xu, Xu, Xu, Xu, Xu, Xu
Xu, Xu, Ww, Wwf, Ss, Ww, Ss, Xu, Ss^Vm, Xu, Xu, Xu, Xu, Xu, Uu^Vud, Uh, Uu, Uu^Tf, Rd, Uu^Tf, Uh, Uh, Uh, Uh, Uh, Xu, Uh, Xu, Uh, Xu, Xu, Xu, Uu, Xu, Uu, Uu^Vud, Uu, Uu, Uu, Uu, Uu, Xu, Xu, Xu, Uu^Vud, Xu, Xu, Wog, Wog, Wog, Xu, Xu, Xu, Xu, Cud, Xu, 4 Kud, Xu, Xu
Xu, Xu, Sm, Ss, Xu, Ss, Wwf, Ss, Ss, Ds, Ds, Xu, Uu^Tf, Uh, Uu, Uu, Rd, Rd, Uu, Rd, Uu, Uu, Uh, Rd, Rd, Rd, Rd, Uu^Tf, Uu, Uu, Uu, Uu, Uu, Uu, Sm, Uu, Uh, Uh, Uh, Uh, Uu, Uu, Xu, Uu, Uu, Uu, Uu, Wog, Wog, Wog, Uu^Tf, Xu, Cud, Cud, Cud, Cud, Cud, Xu, Xu
Rd, Rd, Ss, Ss, Xu, Wwg, Wwg, Ss, Sm, Ss, Rd, Sm, Uu, Uh, Uh, Uu, Xu, Xu, Xu, Uu, Uu, Uu, Uu, Uu, Uu, Uu, Uu, Uu, Uh, Uh, Uh, Uu, Xu, Uu, Uu, Uu, Uu, Uu, Xu, Uu, Uu, Uu, Xu, Uu, Uu, Sm, Uu, Wog, Wog, Wwrg, Rd, Rd, Rd, Cud, Uu, Cud, Uh, Cud, Xu
Uu, Rd, Ss, Xu, Cud, Cme, Cme, Wwf, Ss, Xu, Rd, Rd, Xu, Xu, Xu, Xu, Uu^Tf, Uu^Tf, Rd, Rd, Rd, Uu^Tf, Xu, Xu, Uu, Uu, Rd, Uu, Uu, Uh, Uh, Uu, Xu, Xu, Xu, Uu, Xu, Xu, Uu^Vud, Rd, Rd, Xu, Xu, Uu, Uh, Uu, Wwrg, Wog, Wog^Bw/, Uu, Uu^Tf, Rd, Uu, Uu, Uu^Vud, Uu, Uh, Uh, Xu
Uu, Ss, Ds, Xu, Xu, Cud, 5 Kud, Cud, Xu, Xu, Rd, Uh, Uh, Uu, Sm, Rd, Rd, Uu^Tf, Rd, Rd, Xu, Xu, Uh, Uh, Uu, Rd, Uu, Uu^Tf, Uu, Rd, Rd, Uu, Uu, Uu, Uu, Xu, Uu, Xu, Uu, Rd, Rd, Xu, Xu, Uu, Uh, Uh, Wog^Bw/, Wog^Bw/, Wog, Wog, Uu, Uu, Uu, Uu, Uu, Uu, Uh, Uh, Xu
Uu, Uu, Ss, Ss^Vhs, Ss, Xu, Xu, Xu, Uu^Vud, Uu, Uu, Uh, Uh, Uu, Uu, Uu, Uh, Rd, Uu, Uu, Uh, Uh, Rd, Uh, Uu^Tf, Rd, Uh, Uh, Xu, Xu, Xu, Rd, Uu, Uh, Uh, Uu, Xu, Xu, Uu, Rd, Uu, Uu, Rd, Uh, Rd, Uu, Uu, Wog, Wog, Wog, Xu, Xu, Xu, Uu^Tf, Xu, Uu, Uu, Uu^Tf, Xu
Uu, Uu, Ss, Sm, Ss, Ss, Ds, Uu, Uu, Uu^Tf, Uh, Xu, Xu, Xu, Xu, Xu, Xu, Xu, Uu^Tf, Uu, Uh, Rd, Uh, Uu^Vud, Uh, Uh, Uh, Uh, Xu, Xu, Uh, Xu, Xu, Rd, Rd, Uu, Xu, Uu, Rd, Rd, Uh, Uu, Rd, Rd, Uu, Uu, Uu, Wog, Wog, Wog, Uu, Uu^Vu, Uu, Xu, Uu, Uu, Uu, Uu^Tf, Xu
Wwf, Ss, Wwf, Ss, Ss, Ss, Ss, Uu, Uh, Uu^Tf, Uh, Uh, Uh, Uu^Tf, Rd, Uu, Rd, Rd, Rd, Rd, Uu, Uu, Uu, Xu, Xu, Xu, Xu, Xu, Uu^Vud, Uu^Tf, Uh, Uh, Xu, Uu, Uu, Rd, Rd, Rd, Rd, Uh, Uu, Xu, Uu, Uu, Uu, Uu, Wog, Wog^Bw\, Wog^Bw\, Wog, Uu^Tf, Uu, Uu, Rd, Rd, Rd, Rd, Uu, Xu
Wwf, Wwf, Ww, Wwrg, Ww, Ss, Ss, Ds, Uh, Uh, Xu, Uh, Uh, Rd, Uu^Vud, Rd, Uu^Tf, Rd, Xu, Uu, Xu, Uu, Xu, Xu, Uh, Uh, Uu^Tf, Cud, Cud, Uu^Tf, Uu, Uh, Xu, Xu, Uu, Uu, Uu, Rd, Uu, Uh, Uu, Xu, Xu, Xu, Xu, Xu, Wog, Wog, Uu, Uu, Uu, Uu, Uu, Rd, Uu, Rd, Uu^Tf, Xu, Xu
Wwf, Wwf, Wwf, Ww, Wo, Ww, Ss, Ds, Xu, Xu, Mm^Xm, Xu, Xu, Xu, Xu, Xu, Xu, Xu, Xu, Xu, Xu, Xu, Xu, Uh, Uh, Uh, Cud, Cud, 7 Kud, Cud, Uu, Uu, Uu^Tf, Xu, Uu, Uu, Uu, Uu, Sm, Uu, Xu, Xu, Uu, Uu, Uu, Wog, Wog, Wwrg, Uu, Uu, Uu^Tf, Xu, Uu, Uu, Uu, Uu, Xu, Xu, Gg
Wwf, Wwf, Ww, Ww, Wo, Ww, Wwrg, Ss, Ds, Mm^Xm, Mm^Xm, Mm^Xm, Mm^Xm, Xu, Mm^Xm, Xu, Mm^Xm, Xu, Xu, Xu, Xu, Xu, Xu, Uh, Uu^Tf, Uu^Vud, Uu, Cud, Cud, Cud, Uu, Uu, Uu, Xu, Xu, Xu, Xu, Uu, Uu, Uu, Xu, Xu, Rd, Rd, Uu, Wog, Wog^Bw/, Uu, Uh, Uu^Tf, Xu, Xu, Uu, Rd, Rd, Xu, Xu, Gg, Gs^Fp
Wwf, Wwf, Wwrg, Ww, Ww, Ww, Ww, Ss^Vm, Ss, Gg^Efm, Gg^Efm, Mm^Xm, Mm^Xm, Mm^Xm, Mm^Xm, Mm^Xm, Mm^Xm, Mm^Xm, Mm^Xm, Mm^Xm, Mm^Xm, Xu, Mm^Xm, Xu, Xu, Uu^Tf, Uu, Cud, Uu, Uu, Uu, Uh, Uu^Vud, Uu^Tf, Uh, Uh, Uh, Xu, Uu, Uu, Uu, Uu, Rd, Rd, Uu^Vu, Wog^Bw/, Wog, Uh, Uh, Uh, Xu, Uu, Rd, Rd, Rd, Xu, Gg, Gs^Fp, Gs^Fp
Wwf, Wwf, Wwf, Ww, Wo, Wo, Ww, Ss, Ss, Hh, Gg^Fet, Gs, Md, Md, Md, Md, Md, Md, Ha^Vhha, Mm^Xm, Md, Mm^Xm, Md, Mm^Xm, Mm^Xm, Xu, Xu, Uu, Uu^Tf, Uu^Tf, Uu, Uh, Uh, Uu, Uu, Uh, Uu^Tf, Xu, Xu, Uu, Uu, Uu, Uu, Uu, Wog, Wog, Wog, Uh, Xu, Xu, Xu, Rd, Gg, Gg^Efm, Gg^Efm, Gs^Fp, Gs^Fp, Gs^Fp, Gs^Fp
Wwf, Wwf, Wwf, Ww, Wo, Ww, Wwrg, Ss, Ss, Ss, Gg^Efm, Gs, Md, Md, Hh^Vhh, Md, Gs, Md, Md, Md, Md, Md, Md, Md, Mm^Xm, Mm^Xm, Xu, Xu, Uu^Tf, Uu, Uu^Vud, Uu, Uu^Tf, Uu, Uu, Uu, Uu, Uu, Mm^Xm, Mm^Xm, Mm^Xm, Mm^Xm, Mm^Xm, Mm^Xm, Wog, Wog, Mm^Xm, Mm^Xm, Mm^Xm, Mm^Xm, Mm^Xm, Gg, Gg, Gg^Efm, Gg, Gg, Gg, Gs^Fp, Gg
Wwf, Wwf, Ww, Ww, Ww, Ww, Ss^Vhs, Ss, Ss, Ss, Gg, Md, Md, Md, Md, Md, Md, Md, Mv, Md, Md, Md, Md, Md, Gg, Mm^Xm, Mm^Xm, Xu, Xu, Xu, Xu, Xu, Xu, Uu^Tf, Uu, Uu, Uu, Uu, Mm^Xm, Gg, Gg, Gg^Efm, Wwr, Mm^Xm, Ww, Wwr, Mm^Xm, Mm^Xm, Ch, Ch, Ch, Ch, Ch, Ch, Ch, Ch, Ch, Ch, Ch
Wwf, Wwf, Ww, Ww, Wwf, Ww, Wwf, Wwf, Gg^Fet, Gg, Hh, Md, Md, Md, Md, Md, Md, Md, Md, Md, Md, Md, Gs^Vhr, Md, Gg, Gg, Gg, Mm^Xm, Mm^Xm, Mm^Xm, Mm^Xm, Mm^Xm, Mm^Xm, Xu, Mm^Xm, Uu, Mm^Xm, Mm^Xm, Gg, Gg, Gg^Efm, Gg^Efm, Ww, Ww, Wo, Ww, Rd, Rd, Rd, Rd, Rd, Gg, Rd, Gg, Rd, Gg, Rd, Gg, Gg
Wwf, Wwf, Wwf, Wwf, Wwf, Wwf, Wwf, Wwf, Gg^Efm, Gg^Efm, Wo, Wwr, Mm^Xm, Mm^Xm, Mm^Xm, Md, Md, Md, Md, Md, Md, Md, Gs, Md, Gg, Gg, Gs^Fdf, Gg, Gg, Gg, Gg, Gg, Gg, Mm^Xm, Gg, Mm^Xm, Gs^Fds, Gs^Fds, Gs^Fds, Gg^Fet, Gg^Efm, Gg, Ww, Wo, Wo^Bw/, Ww^Bw/, Gg, Rd, Gg, Rd, Gg^Vhr, Rd, Gg, Rd, Gg, Rd, Gg^Fet, Rd, Rd
Wwf, Wwf, Wwf, Wwf, Mm^Xm, Mm^Xm, Mm^Xm, Mm^Xm, Mm^Xm, Mm^Xm, Mm^Xm, Wo, Sm, Mm^Xm, Mm^Xm, Mm^Xm, Mm^Xm, Hh^Vhh, Md, Md, Md, Md, Gg, Gg, Gs^Fdf, Gs^Fdf, Sm, Gg, Gg, Gg, Gg, Gg, Gg^Fet, Gg^Efm, Gg, Gs^Fds, Gs^Fds, Gs^Fds, Gs^Fds, Gg^Ve, Gg, Gg, Ww^Bw/, Ww^Bw/, Wo, Ww, Gg, Ch, Gg, Gg, Gg^Efm, Gg^Efm, Cvr, Cv, Cvr, Gg, Gg, Gg^Ve, Gg
Mm^Xm, Mm^Xm, Mm^Xm, Mm^Xm, Mm^Xm, Mm^Xm, Mm^Xm, Mm^Xm, Mm^Xm, Mm^Xm, Gs^Fp, Gs^Fp, Gs^Fp, Gs^Fp, Gg, Mm^Xm, Mm^Xm, Md, Md, Md, Gg, Gg, Gg, Gs^Fdf, Gs^Fdf, Gs^Fdf, Gs^Fdf, Gs^Fdf, Gg^Fet, Gg, Gs^Fdf, Gg, Gg, Gg, Gs^Fds, Gs^Fds, Gs^Fds, Gs^Fds, Rd, Gg, Rd, Rd, Ww, Ww, Wo, Ww, Gg, Ch, Gg, Gg^Fet, Gg, Gg, Cvr, Cv, Cvr, Cvr, Gg, Gg^Efm, Gg
Mm^Xm, Mm^Xm, Mm^Xm, Mm^Xm, Mm^Xm, Mm^Xm, Mm^Xm, Mm^Xm, Mm^Xm, Mm^Xm, Gs^Fp, Gs^Fp, Gs^Fp, Gs^Fp, Gs^Fp, Gg, Mm^Xm, Mm^Xm, Mm^Xm, Mm^Xm, Gg, Gg, Gg, Gs^Fdf, Gg, Gg, Gg, Gs^Fdf, Gs^Fdf, Gs^Fdf, Gs^Fdf, Gs^Fdf, Gs^Fdf, Gg, Gg, Gg, Rd, Gg, Rd, Rd, Rd, Ww, Ww, Wo, Ww, Ww, Gg^Fet, Ch, Gg, Gg, Gg^Efm, Gg, Cv, Cvr, 3 Kvr, Cv, Gg, Gg, Gg
Mm^Xm, Mm^Xm, Mm^Xm, Mm^Xm, Mm^Xm, Mm^Xm, Gs^Fp, Gg, Gg^Fet, Gs^Fp, Gs^Fp, Gg, Gs^Fp, Gs^Fp, Gs^Fp, Gs^Fp, Gg^Efm, Gg, Gs^Fp, Gg, Gs^Fp, Gs^Fp, Gs^Fp, Gg, Gg^Efm, Gg^Fet, Gg, Gs^Fdf, Gs^Fdf, Gg^Ve, Gs^Fdf, Gs^Fdf, Gg, Gg^Efm, Rd, Rd, Gg^Efm, Rd, Gs^Fp, Gg, Ww, Ww^Bw\, Wo^Bw\, Ww, Ww, Ww, Gg, Ch, Gg, Gg^Efm, Gg, Gg, Cv, Cvr, Cv, Cvr, Gg, Gg^Fet, Gg
Mm^Xm, Mm^Xm, Mm^Xm, Mm^Xm, Gg^Efm, Gg, Gs^Fp, Gs^Fp, Gs^Fp, Gg, Gs^Fp, Gg^Fet, Gs^Fp, Gs^Fp, Gs^Fp, Gs^Fp, Gs^Fp, Gg, Gs^Fp, Gs^Fp, Gg, Gs^Fp, Gg, Gg^Efm, Gg, Gg, Gg, Gs^Fdf, Gs^Fdf, Gs^Fdf, Gs^Fdf, Gs^Fdf, Gg^Fet, Gg, Rd, Rd, Rd, Gg^Fet, Gs^Fp, Gs^Fp, Ww, Wo, Ww, Rd, Ww^Bw\, Ww, Wwr, Ch, Gg, Gg, Gg^Fet, Gg, Gg, Cvr, Cvr, Cvr, Gg, Gg, Gg
Mm^Xm, Mm^Xm, Gg, Gg, Ce, Gg, Gg, Gs^Fp, Gs^Fp, Gs^Fp, Gs^Fp, Gs^Fp, Gs^Fp, Gs^Fp, Gs^Fp, Gs^Fp, Gs^Fp, Gg^Fet, Gs^Fp, Gs^Fp, Gg^Fet, Gg, Gg^Efm, Gg, Gs^Fdw, Gs^Fdw, Gg, Gg^Efm, Gg, Gg, Rd, Rd, Rd, Rd, Gg, Rd, Rd, Rd, Rd, Wwr, Ww, Ww, Gs^Fms, Gg^Ve, Gg, Ww^Bw\, Ww^Bw\, Ch, Gg^Efm, Gg, Gg, Gg, Gg^Efm, Gg, Gg, Cvr, Rd, Gg^Efm, Rd
Mm^Xm, Mm, Gg, Ce, 2 Ke, Ce, Gg, Gs^Fp, Gs^Fp, Gs^Fp, Gs^Fp, Gg^Fet, Gs^Fp, Gs^Fp, Gg^Fet, Gs^Fp, Gs^Fp, Gs^Fp, Gg, Gs^Fp, Gs^Fp, Gg, Gg, Gg, Gs^Fdw, Gg, Gg^Fet, Gg, Rd, Rd, Gg, Rd, Gg, Gg^Efm, Gs^Fp, Gg, Gs^Fp, Gs^Fp, Ww, Ww^Bw\, Ww^Bw\, Ww, Gs^Fms, Gs^Fms, Gg, Ww, Ww, Rd, Rd, Gg^Ve, Rd, Gg^Efm, Rd, Rd, Rd, Rd, Gg^Efm, Rd, Gg
Gg, Gg, Gg^Efm, Ce, Ce, Ce, Gg, Gs^Fp, Gs^Fp, Gs^Fp, Gs^Fp, Gs^Fp, Gs^Fp, Gs^Fp, Gs^Fp, Gs^Fp, Gs^Fp, Gs^Fp, Gg, Gs^Fp, Gs^Fp, Gs^Fp, Gs^Fp, Gg, Gs^Fdw, Gs^Fdw, Rd, Rd, Gs^Fdw, Gg, Gs^Fdw, Gg, Gg, Gg^Efm, Gg, Gs^Fp, Gs^Fp, Gs^Fp, Ww, Ww, Ww, Rd, Gs^Fms, Gs^Fms, Gg, Ww, Ww, Ch, Rd, Rd, Rd, Rd, Gg^Fet, Gg^Vwm, Gg, Gg, Gg^Efm, Gg^Vhr, Gg
Gg, Gg, Gg^Efm, Gg, Gg, Gg, Gg, Gs^Fp, Gs^Fp, Gs^Fp, Gs^Fp, Gs^Fp, Gg^Efm, Gs^Fp, Gs^Fp, Gs^Fp, Gs^Fp, Gs^Fp, Gg^Fet, Gg, Gs^Fp, Gs^Fp, Gs^Fp, Gg, Rd, Rd, Gg^Efm, Gs^Fdw, Gs^Fdw, Gs^Fdw, Sm, Gg^Efm, Gg, Gg^Fet, Mm^Xm, Mm^Xm, Mm^Xm, Gg, Mm^Xm, Ww, Ww, Rd, Rd, Gs^Fms, Wwr, Ww, Ww^Bw/, Rd, Gg, Gg, Gg^Efm, Gg, Gg^Efm, Gg, Gg, Gg^Fet, Gg, Gg, Gg
Gg, Gg^Fet, Gs^Vc, Gg^Efm, Gg, Gg^Fet, Gg, Gs^Fp, Gs^Fp, Gg, Gs^Fp, Gg^Fet, Gg, Gg, Gs^Fp, Gg^Fet, Gs^Fp, Gg, Gg, Gg^Efm, Gg^Efm, Gs^Fp, Gs^Fp, Gg, Rd, Gg^Efm, Gs^Fdw, Gs^Fdw, Gs^Fdw, Gs^Fdw, Gg, Gg, Mm^Xm, Mm^Xm, Uu, Uu, Uu, Mm^Xm, Xu, Ww, Ww, Gg, Rd, Gs^Fms, Ww^Bw/, Ww^Bw/, Gg, Ch, Gg, Gg, Ch, Gg, Ch, Gg, Ch, Gg, Ch, Gg, Ch
Gg, Gg, Gg, Gg, Ce, Gg, Gg, Gg, Gg, Gg, Gs^Fp, Gs^Fp, Gg^Fet, Gs^Fp, Gs^Fp, Gg^Efm, Gs^Fp, Gs^Fp, Gs^Fp, Gs^Fp, Gs^Fp, Gg, Rd, Rd, Gg, Gs^Fdw, Gs^Fdw, Gs^Fdw, Gs^Fdw, Gg, Gg^Fet, Gg, Mm^Xm, Uu, Uu, Uu, Uu, Uu^Tf, Xu, Ww, Wo, Ww, Gg^Vhr, Rd, Ww, Ww, Gg, Gg, Gg, Ch, Gg, Ch, Gg, Ch, Gg, Ch, Gg, Ch, Gg
Mm, Gg, Gg, Ce, 1 Ke, Ce, Gg, Gg^Fet, Gg, Gg^Fet, Gs^Fp, Gs^Fp, Gs^Fp, Gs^Fp, Gs^Fp, Gs^Fp, Gg^Fet, Gs^Fp, Gs^Fp, Gs^Fp, Gg, Gs^Fp, Rd, Gg^Vhr, Gg, Gg, Gs^Fdw, Gs^Fdw, Gs^Fdw, Gg, Gg, Gg, Mm^Xm, Xu, Uu^Tf, Uu, Uh, Uu^Tf, Xu, Wwr, Wo, Ww, Ww, Ww, Wo, Ww, Ww, Gg^Efm, Gg^Fet, Gg, Gg, Gg, Gg, Gg^Efm, Gg^Efm, Gg, Gg, Gg, Gg
Mm^Xm, Gg, Gg, Ce, Ce, Ce, Gs^Fp, Gg, Gs^Fp, Gs^Fp, Sm, Gs^Fp, Gs^Fp, Gg, Gs^Fp, Gs^Fp, Gs^Fp, Gs^Fp, Gg, Gg, Rd, Rd, Gs^Fp, Gg, Gg, Gg^Fet, Gs^Fdw, Gs^Fdw, Gs^Fdw, Gg^Efm, Gg, Mm^Xm, Xu, Xu, Uh, Uh, Uh, Uu, Uu^Tf, Xu, Xu, Wo, Wo, Ww, Wo, Ww, Ww, Ww, Gg, Gg, Gg^Ve, Gg, Gg, Gg^Efm, Gg, Gg, Gg^Fet, Gg, Gg
Mm^Xm, Mm, Rd, Gg, Gg, Gg, Gg^Efm, Gs^Fp, Gg^Efm, Gg^Fet, Gg, Gs^Fp, Gs^Fp, Gs^Fp, Gs^Fp, Gs^Fp, Gs^Fp, Gs^Fp, Gg, Gg^Fet, Rd, Rd, Gs^Fp, Gs^Fp, Mm^Xm, Gg, Mm^Xm, Gs^Fdw, Gg, Gg, Mm^Xm, Mm^Xm, Xu, Xu, Uu^Tf, Uh, Uh, Uu^Vu, Uu, Cud, Cud, Xu, Xu, Wo, Wo, Wo, Ww, Ww, Ww, Gg, Gg, Gg, Gg, Gg, Gg, Gg^Vh, Gg^Efm, Gg, Gg
Mm^Xm, Mm^Xm, Mm^Xm, Rd, Rd, Gg, Rd, Gg^Efm, Gg^Efm, Gg, Gg, Gg^Fet, Gs^Fp, Gs^Fp, Gs^Fp, Gg^Fet, Gs^Fp, Gs^Fp, Rd, Rd, Gs^Fp, Gs^Fp, Mm^Xm, Mm^Xm, Mm^Xm, Mm^Xm, Mm^Xm, Gg, Mm^Xm, Mm^Xm, Mm^Xm, Mm^Xm, Xu, Uu^Tf, Uu^Tf, Uu, Uu^Tf, Uu, Cud, Cud, Cud, 6 Kud, Xu, Xu, Wo, Wo, Wo, Ww, Ww, Gg, Gg, Gg^Efm, Gg, Gg^Fet, Gg, Gg^Efm, Gg, Gg, Gg
Mm^Xm, Mm^Xm, Mm^Xm, Mm^Xm, Mm^Xm, Rd, Rd, Rd, Rd, Rd, Rd, Rd, Rd, Rd, Rd, Rd, Rd, Rd, Gs^Fp, Gs^Fp, Gg, Gg, Mm^Xm, 8 Mm^Xm, Mm^Xm, Mm^Xm, Mm^Xm, Mm^Xm, Mm^Xm, Mm^Xm, Xu, Xu, Xu, Xu, Xu, Uu, Xu, Uu, Xu, Cud, Xu, Cud, Xu, Xu, Xu, Wo, Wo, Ww, Ww, Gg, Gg^Fet, Gg, Gg^Efm, Gg, Gg, Gg, Gg, Gg, Gg
Mm^Xm, Mm^Xm, Mm^Xm, Mm^Xm, Mm^Xm, Gg, Gg, Gg^Fet, Gg, Gg, Gg, Gg, Gg, Gg, Gg, Gg, Gg, Gg, Gg, Gs^Fp, Gg, Gg, Mm^Xm, Mm^Xm, Mm^Xm, Mm^Xm, Mm^Xm, Mm^Xm, Mm^Xm, Mm^Xm, Xu, Xu, Xu, Xu, Xu, Xu, Xu, Xu, Xu, Xu, Xu, Xu, Xu, Xu, Xu, Wo, Wo, Wo, Ww, Wwr, Gg, Gg, Gg, Gg, Gg, Gg, Gg, Gg^Fet, Gg
